GEOCODE,NAME,total_pop,one_race_pop,multi_race,hisp_latino,not_hisp_latino,one_race_nh,white_alone_nh,black_alone_nh,asian_alone_nh,other_races,pct_hisp_lat,pct_multi_race,pct_white,pct_black,pct_asian,pct_other_races
21001970100,Census Tract 9701,1621,1559,51,36,1585,1534,1525,6,0,3,2.22,3.15,94.08,0.37,0.0,0.19
21001970200,Census Tract 9702,1755,1701,43,54,1701,1658,1616,35,0,7,3.08,2.45,92.08,1.99,0.0,0.4
21001970300,Census Tract 9703,3005,2916,63,103,2902,2839,2818,9,9,3,3.43,2.1,93.78,0.3,0.3,0.1
21001970401,Census Tract 9704.01,4346,4194,126,171,4175,4049,3835,196,9,9,3.93,2.9,88.24,4.51,0.21,0.21
21001970402,Census Tract 9704.02,4535,4378,132,199,4336,4204,3894,226,37,47,4.39,2.91,85.87,4.98,0.82,1.04
21001970500,Census Tract 9705,2334,2222,97,55,2279,2182,2122,19,8,33,2.36,4.16,90.92,0.81,0.34,1.41
21001970600,Census Tract 9706,1307,1256,41,25,1282,1241,1234,7,0,0,1.91,3.14,94.41,0.54,0.0,0.0
21003920100,Census Tract 9201,3295,3189,85,93,3202,3117,3070,31,0,16,2.82,2.58,93.17,0.94,0.0,0.49
21003920200,Census Tract 9202,2868,2739,96,64,2804,2708,2697,3,3,5,2.23,3.35,94.04,0.1,0.1,0.17
21003920300,Census Tract 9203,5101,4876,176,138,4963,4787,4660,85,26,16,2.71,3.45,91.35,1.67,0.51,0.31
21003920400,Census Tract 9204,4563,4345,175,128,4435,4260,4156,63,9,32,2.81,3.84,91.08,1.38,0.2,0.7
21003920500,Census Tract 9205,1413,1354,39,46,1367,1328,1313,7,5,3,3.26,2.76,92.92,0.5,0.35,0.21
21003920600,Census Tract 9206,3348,3187,118,105,3243,3125,3091,15,5,14,3.14,3.52,92.32,0.45,0.15,0.42
21005950101,Census Tract 9501.01,1987,1913,58,45,1942,1884,1841,38,5,0,2.26,2.92,92.65,1.91,0.25,0.0
21005950102,Census Tract 9501.02,6988,6619,310,178,6810,6500,6171,262,31,36,2.55,4.44,88.31,3.75,0.44,0.52
21005950201,Census Tract 9502.01,5681,5399,236,140,5541,5305,5132,115,35,23,2.46,4.15,90.34,2.02,0.62,0.4
21005950202,Census Tract 9502.02,3966,3756,180,72,3894,3714,3624,40,19,31,1.82,4.54,91.38,1.01,0.48,0.78
21005950300,Census Tract 9503,2382,2279,88,47,2335,2247,2218,12,13,4,1.97,3.69,93.12,0.5,0.55,0.17
21005950400,Census Tract 9504,2848,2740,97,39,2809,2712,2668,15,1,28,1.37,3.41,93.68,0.53,0.04,0.98
21007950100,Census Tract 9501,3975,3793,157,38,3937,3780,3629,130,14,7,0.96,3.95,91.3,3.27,0.35,0.18
21007950200,Census Tract 9502,1420,1356,59,15,1405,1346,1291,50,5,0,1.06,4.15,90.92,3.52,0.35,0.0
21007950300,Census Tract 9503,2333,2213,96,40,2293,2197,2154,28,10,5,1.71,4.11,92.33,1.2,0.43,0.21
21009950100,Census Tract 9501,3590,3475,84,111,3479,3395,3278,72,30,15,3.09,2.34,91.31,2.01,0.84,0.42
21009950200,Census Tract 9502,3537,3371,141,115,3422,3281,3087,150,29,15,3.25,3.99,87.28,4.24,0.82,0.42
21009950300,Census Tract 9503,3507,3304,152,143,3364,3212,3053,130,8,21,4.08,4.33,87.05,3.71,0.23,0.6
21009950401,Census Tract 9504.01,2637,2435,137,252,2385,2248,1877,270,58,43,9.56,5.2,71.18,10.24,2.2,1.63
21009950402,Census Tract 9504.02,3612,3351,192,222,3390,3198,2777,374,9,38,6.15,5.32,76.88,10.35,0.25,1.05
21009950500,Census Tract 9505,4033,3815,167,212,3821,3654,3405,198,30,21,5.26,4.14,84.43,4.91,0.74,0.52
21009950601,Census Tract 9506.01,3048,2863,153,183,2865,2712,2440,233,11,28,6.0,5.02,80.05,7.64,0.36,0.92
21009950602,Census Tract 9506.02,3318,3046,79,246,3072,2993,2786,135,51,21,7.41,2.38,83.97,4.07,1.54,0.63
21009950701,Census Tract 9507.01,2269,2194,65,37,2232,2167,2126,33,5,3,1.63,2.86,93.7,1.45,0.22,0.13
21009950702,Census Tract 9507.02,4046,3905,111,75,3971,3860,3765,48,15,32,1.85,2.74,93.05,1.19,0.37,0.79
21009950800,Census Tract 9508,3497,3382,77,102,3395,3318,3279,24,6,9,2.92,2.2,93.77,0.69,0.17,0.26
21009950900,Census Tract 9509,3913,3792,80,104,3809,3729,3709,4,0,16,2.66,2.04,94.79,0.1,0.0,0.41
21009951000,Census Tract 9510,3478,3324,116,87,3391,3275,3222,26,3,24,2.5,3.34,92.64,0.75,0.09,0.69
21011970100,Census Tract 9701,1932,1872,44,48,1884,1840,1777,55,3,5,2.48,2.28,91.98,2.85,0.16,0.26
21011970201,Census Tract 9702.01,2646,2576,60,21,2625,2565,2512,41,5,7,0.79,2.27,94.94,1.55,0.19,0.26
21011970202,Census Tract 9702.02,4610,4492,90,82,4528,4438,4404,29,3,2,1.78,1.95,95.53,0.63,0.07,0.04
21011970300,Census Tract 9703,3562,3465,86,31,3531,3445,3432,2,5,6,0.87,2.41,96.35,0.06,0.14,0.17
21013960100,Census Tract 9601,1825,1773,51,5,1820,1769,1759,5,0,5,0.27,2.79,96.38,0.27,0.0,0.27
21013960200,Census Tract 9602,4129,3997,115,31,4098,3983,3902,52,8,21,0.75,2.79,94.5,1.26,0.19,0.51
21013960300,Census Tract 9603,1865,1809,50,7,1858,1808,1797,6,2,3,0.38,2.68,96.35,0.32,0.11,0.16
21013960400,Census Tract 9604,1292,1246,44,6,1286,1242,1238,3,0,1,0.46,3.41,95.82,0.23,0.0,0.08
21013960500,Census Tract 9605,2096,2021,64,69,2027,1963,1915,40,6,2,3.29,3.05,91.36,1.91,0.29,0.1
21013960600,Census Tract 9606,4478,4298,172,32,4446,4274,3976,236,43,19,0.71,3.84,88.79,5.27,0.96,0.42
21013960700,Census Tract 9607,2655,2509,126,46,2609,2483,2320,106,41,16,1.73,4.75,87.38,3.99,1.54,0.6
21013960800,Census Tract 9608,3223,3109,102,34,3189,3087,3029,20,21,17,1.05,3.16,93.98,0.62,0.65,0.53
21013961100,Census Tract 9611,2534,2484,50,14,2520,2470,2375,84,1,10,0.55,1.97,93.73,3.31,0.04,0.39
21015070101,Census Tract 701.01,4045,3723,182,490,3555,3373,2902,403,54,14,12.11,4.5,71.74,9.96,1.33,0.35
21015070102,Census Tract 701.02,2868,2562,193,310,2558,2365,1873,425,21,46,10.81,6.73,65.31,14.82,0.73,1.6
21015070201,Census Tract 702.01,3863,3546,183,514,3349,3166,2681,425,36,24,13.31,4.74,69.4,11.0,0.93,0.62
21015070202,Census Tract 702.02,2961,2729,158,341,2620,2462,2077,337,26,22,11.52,5.34,70.15,11.38,0.88,0.74
21015070301,Census Tract 703.01,5992,5275,399,1328,4664,4265,3622,565,44,34,22.16,6.66,60.45,9.43,0.73,0.57
21015070305,Census Tract 703.05,6572,6171,278,306,6266,5988,5588,261,90,49,4.66,4.23,85.03,3.97,1.37,0.75
21015070309,Census Tract 703.09,6546,6167,256,225,6321,6065,5650,104,272,39,3.44,3.91,86.31,1.59,4.16,0.6
21015070311,Census Tract 703.11,2711,2495,147,187,2524,2377,2146,125,14,92,6.9,5.42,79.16,4.61,0.52,3.39
21015070312,Census Tract 703.12,3131,2906,127,242,2889,2762,2404,194,129,35,7.73,4.06,76.78,6.2,4.12,1.12
21015070313,Census Tract 703.13,3296,3141,122,128,3168,3046,2866,86,78,16,3.88,3.7,86.95,2.61,2.37,0.49
21015070314,Census Tract 703.14,4997,4680,221,270,4727,4506,4083,132,239,52,5.4,4.42,81.71,2.64,4.78,1.04
21015070315,Census Tract 703.15,5914,5514,237,474,5440,5203,4529,465,167,42,8.01,4.01,76.58,7.86,2.82,0.71
21015070316,Census Tract 703.16,6903,6514,248,309,6594,6346,5588,235,487,36,4.48,3.59,80.95,3.4,7.05,0.52
21015070317,Census Tract 703.17,5254,4962,222,179,5075,4853,4413,216,176,48,3.41,4.23,83.99,4.11,3.35,0.91
21015070318,Census Tract 703.18,8353,7846,388,286,8067,7679,7212,257,168,42,3.42,4.65,86.34,3.08,2.01,0.5
21015070403,Census Tract 704.03,6820,6397,323,232,6588,6265,5945,102,166,52,3.4,4.74,87.17,1.5,2.43,0.76
21015070404,Census Tract 704.04,3772,3546,162,126,3646,3484,3274,103,84,23,3.34,4.29,86.8,2.73,2.23,0.61
21015070405,Census Tract 704.05,2336,2227,93,41,2295,2202,2173,6,12,11,1.76,3.98,93.02,0.26,0.51,0.47
21015070406,Census Tract 704.06,2647,2473,132,161,2486,2354,2234,72,32,16,6.08,4.99,84.4,2.72,1.21,0.6
21015070407,Census Tract 704.07,3548,3247,228,168,3380,3152,2896,200,22,34,4.74,6.43,81.62,5.64,0.62,0.96
21015070502,Census Tract 705.02,4327,4141,154,77,4250,4096,4058,14,8,16,1.78,3.56,93.78,0.32,0.18,0.37
21015070503,Census Tract 705.03,6614,6120,331,357,6257,5926,5518,217,129,62,5.4,5.0,83.43,3.28,1.95,0.94
21015070505,Census Tract 705.05,3708,3497,179,90,3618,3439,3308,87,32,12,2.43,4.83,89.21,2.35,0.86,0.32
21015070506,Census Tract 705.06,4245,4025,181,203,4042,3861,3509,279,42,31,4.78,4.26,82.66,6.57,0.99,0.73
21015070601,Census Tract 706.01,2936,2814,95,59,2877,2782,2732,7,33,10,2.01,3.24,93.05,0.24,1.12,0.34
21015070604,Census Tract 706.04,3454,3310,104,74,3380,3276,3220,9,23,24,2.14,3.01,93.23,0.26,0.67,0.69
21015070605,Census Tract 706.05,7985,7646,268,176,7809,7541,7051,145,325,20,2.2,3.36,88.3,1.82,4.07,0.25
21015070606,Census Tract 706.06,5660,5332,270,188,5472,5202,5048,63,59,32,3.32,4.77,89.19,1.11,1.04,0.57
21015070607,Census Tract 706.07,4453,4226,154,164,4289,4135,3951,74,80,30,3.68,3.46,88.73,1.66,1.8,0.67
21015980100,Census Tract 9801,57,56,1,2,55,54,51,1,0,2,3.51,1.75,89.47,1.75,0.0,3.51
21017030101,Census Tract 301.01,2175,2007,121,212,1963,1842,1431,393,2,16,9.75,5.56,65.79,18.07,0.09,0.74
21017030102,Census Tract 301.02,1726,1651,53,113,1613,1560,1495,49,9,7,6.55,3.07,86.62,2.84,0.52,0.41
21017030201,Census Tract 302.01,4348,4094,200,388,3960,3760,3422,291,23,24,8.92,4.6,78.7,6.69,0.53,0.55
21017030202,Census Tract 302.02,1949,1779,140,162,1787,1647,1476,154,3,14,8.31,7.18,75.73,7.9,0.15,0.72
21017030300,Census Tract 303,3170,2985,101,307,2863,2762,2683,50,18,11,9.68,3.19,84.64,1.58,0.57,0.35
21017030400,Census Tract 304,2443,2374,52,105,2338,2286,2230,38,11,7,4.3,2.13,91.28,1.56,0.45,0.29
21017030500,Census Tract 305,2331,2275,45,95,2236,2191,2128,37,9,17,4.08,1.93,91.29,1.59,0.39,0.73
21017030600,Census Tract 306,2110,2014,68,104,2006,1938,1905,21,2,10,4.93,3.22,90.28,1.0,0.09,0.47
21019030200,Census Tract 302,1438,1355,68,25,1413,1345,1236,73,22,14,1.74,4.73,85.95,5.08,1.53,0.97
21019030300,Census Tract 303,2053,1905,138,99,1954,1816,1654,119,24,19,4.82,6.72,80.57,5.8,1.17,0.93
21019030400,Census Tract 304,2163,2041,106,51,2112,2006,1923,67,9,7,2.36,4.9,88.9,3.1,0.42,0.32
21019030500,Census Tract 305,4409,4217,156,87,4322,4166,4030,78,27,31,1.97,3.54,91.4,1.77,0.61,0.7
21019030600,Census Tract 306,4361,4172,162,64,4297,4135,3988,98,37,12,1.47,3.71,91.45,2.25,0.85,0.28
21019030700,Census Tract 307,3364,3212,136,49,3315,3179,3074,77,23,5,1.46,4.04,91.38,2.29,0.68,0.15
21019030800,Census Tract 308,3913,3672,231,53,3860,3629,3466,127,7,29,1.35,5.9,88.58,3.25,0.18,0.74
21019030900,Census Tract 309,5187,4987,185,46,5141,4956,4841,53,35,27,0.89,3.57,93.33,1.02,0.67,0.52
21019031001,Census Tract 310.01,1283,1256,24,10,1273,1249,1224,10,5,10,0.78,1.87,95.4,0.78,0.39,0.78
21019031003,Census Tract 310.03,3139,3077,52,80,3059,3007,2474,490,32,11,2.55,1.66,78.81,15.61,1.02,0.35
21019031004,Census Tract 310.04,3518,3387,113,30,3488,3375,3343,22,5,5,0.85,3.21,95.03,0.63,0.14,0.14
21019031101,Census Tract 311.01,5723,5568,118,63,5660,5542,5466,34,25,17,1.1,2.06,95.51,0.59,0.44,0.3
21019031102,Census Tract 311.02,2106,2022,71,20,2086,2015,1987,19,2,7,0.95,3.37,94.35,0.9,0.09,0.33
21019031200,Census Tract 312,3254,3141,105,19,3235,3130,3099,9,11,11,0.58,3.23,95.24,0.28,0.34,0.34
21019031300,Census Tract 313,2350,2290,53,18,2332,2279,2230,30,13,6,0.77,2.26,94.89,1.28,0.55,0.26
21021930100,Census Tract 9301,6415,5891,272,403,6012,5740,5002,656,44,38,6.28,4.24,77.97,10.23,0.69,0.59
21021930200,Census Tract 9302,4762,4494,219,161,4601,4382,4039,264,59,20,3.38,4.6,84.82,5.54,1.24,0.42
21021930300,Census Tract 9303,3293,3068,176,169,3124,2948,2422,359,152,15,5.13,5.34,73.55,10.9,4.62,0.46
21021930400,Census Tract 9304,4344,3914,267,450,3894,3627,2998,571,33,25,10.36,6.15,69.01,13.14,0.76,0.58
21021930500,Census Tract 9305,3506,3330,148,81,3425,3277,3048,181,37,11,2.31,4.22,86.94,5.16,1.06,0.31
21021930600,Census Tract 9306,3751,3581,145,64,3687,3542,3470,46,9,17,1.71,3.87,92.51,1.23,0.24,0.45
21021930700,Census Tract 9307,4543,4326,169,162,4381,4212,4095,78,27,12,3.57,3.72,90.14,1.72,0.59,0.26
21023950100,Census Tract 9501,2464,2377,77,46,2418,2341,2306,24,6,5,1.87,3.12,93.59,0.97,0.24,0.2
21023950200,Census Tract 9502,1793,1729,61,12,1781,1720,1706,6,3,5,0.67,3.4,95.15,0.33,0.17,0.28
21023950300,Census Tract 9503,4143,4001,127,32,4111,3984,3952,18,4,10,0.77,3.07,95.39,0.43,0.1,0.24
21025920200,Census Tract 9202,2170,2129,40,18,2152,2112,2077,26,6,3,0.83,1.84,95.71,1.2,0.28,0.14
21025920301,Census Tract 9203.01,1893,1856,36,10,1883,1847,1822,10,14,1,0.53,1.9,96.25,0.53,0.74,0.05
21025920302,Census Tract 9203.02,1668,1614,51,8,1660,1609,1577,8,17,7,0.48,3.06,94.54,0.48,1.02,0.42
21025920500,Census Tract 9205,1692,1666,23,6,1686,1663,1656,1,0,6,0.35,1.36,97.87,0.06,0.0,0.35
21025920600,Census Tract 9206,1950,1908,41,11,1939,1898,1895,2,0,1,0.56,2.1,97.18,0.1,0.0,0.05
21025920700,Census Tract 9207,1986,1750,219,24,1962,1743,1737,4,0,2,1.21,11.03,87.46,0.2,0.0,0.1
21025920800,Census Tract 9208,2359,2294,61,16,2343,2282,2274,6,0,2,0.68,2.59,96.4,0.25,0.0,0.08
21027960100,Census Tract 9601,5019,4767,217,81,4938,4721,4486,189,7,39,1.61,4.32,89.38,3.77,0.14,0.78
21027960200,Census Tract 9602,5202,4975,192,63,5139,4947,4739,175,20,13,1.21,3.69,91.1,3.36,0.38,0.25
21027960300,Census Tract 9603,3028,2865,145,36,2992,2847,2812,26,0,9,1.19,4.79,92.87,0.86,0.0,0.3
21027960400,Census Tract 9604,1375,1315,58,3,1372,1314,1304,1,0,9,0.22,4.22,94.84,0.07,0.0,0.65
21027960501,Census Tract 9605.01,2056,1927,113,52,2004,1891,1845,14,3,29,2.53,5.5,89.74,0.68,0.15,1.41
21027960502,Census Tract 9605.02,3752,3618,110,49,3703,3593,3557,17,8,11,1.31,2.93,94.8,0.45,0.21,0.29
21029020101,Census Tract 201.01,4388,4166,183,91,4297,4114,4049,34,17,14,2.07,4.17,92.27,0.77,0.39,0.32
21029020102,Census Tract 201.02,3865,3683,146,80,3785,3639,3564,36,20,19,2.07,3.78,92.21,0.93,0.52,0.49
21029020103,Census Tract 201.03,3310,3125,164,59,3251,3087,3051,5,19,12,1.78,4.95,92.18,0.15,0.57,0.36
21029020201,Census Tract 202.01,7459,7115,267,125,7334,7067,6894,106,39,28,1.68,3.58,92.43,1.42,0.52,0.38
21029020202,Census Tract 202.02,4769,4582,146,99,4670,4524,4405,60,31,28,2.08,3.06,92.37,1.26,0.65,0.59
21029020300,Census Tract 203,5661,5407,219,117,5544,5325,5207,57,33,28,2.07,3.87,91.98,1.01,0.58,0.49
21029020401,Census Tract 204.01,1693,1611,63,25,1668,1605,1574,10,12,9,1.48,3.72,92.97,0.59,0.71,0.53
21029020402,Census Tract 204.02,5206,4913,222,152,5054,4832,4693,80,35,24,2.92,4.26,90.15,1.54,0.67,0.46
21029020501,Census Tract 205.01,3197,2975,166,134,3063,2897,2799,62,29,7,4.19,5.19,87.55,1.94,0.91,0.22
21029020502,Census Tract 205.02,2213,2079,101,94,2119,2018,1932,61,15,10,4.25,4.56,87.3,2.76,0.68,0.45
21029020601,Census Tract 206.01,5541,5181,257,187,5354,5097,4959,88,16,34,3.37,4.64,89.5,1.59,0.29,0.61
21029020602,Census Tract 206.02,1289,1252,31,18,1271,1240,1221,6,11,2,1.4,2.4,94.72,0.47,0.85,0.16
21029020702,Census Tract 207.02,2546,2389,137,81,2465,2328,2261,41,14,12,3.18,5.38,88.81,1.61,0.55,0.47
21029020703,Census Tract 207.03,4405,4143,206,101,4304,4098,3914,122,50,12,2.29,4.68,88.85,2.77,1.14,0.27
21029020704,Census Tract 207.04,3639,3381,202,135,3504,3302,3166,79,34,23,3.71,5.55,87.0,2.17,0.93,0.63
21029020800,Census Tract 208,5005,4750,203,229,4776,4573,4471,51,24,27,4.58,4.06,89.33,1.02,0.48,0.54
21029020900,Census Tract 209,2792,2684,87,59,2733,2646,2614,10,6,16,2.11,3.12,93.62,0.36,0.21,0.57
21029021102,Census Tract 211.02,4442,4229,175,96,4346,4171,4126,21,6,18,2.16,3.94,92.89,0.47,0.14,0.41
21029021103,Census Tract 211.03,1384,1305,62,28,1356,1294,1273,7,3,11,2.02,4.48,91.98,0.51,0.22,0.79
21029021104,Census Tract 211.04,4625,4368,214,141,4484,4270,4165,73,17,15,3.05,4.63,90.05,1.58,0.37,0.32
21029021200,Census Tract 212,4786,4548,214,66,4720,4506,4447,22,14,23,1.38,4.47,92.92,0.46,0.29,0.48
21029980100,Census Tract 9801,2,2,0,0,2,2,2,0,0,0,0.0,0.0,100.0,0.0,0.0,0.0
21031930100,Census Tract 9301,3101,3006,83,49,3052,2969,2951,5,0,13,1.58,2.68,95.16,0.16,0.0,0.42
21031930200,Census Tract 9302,1616,1575,35,12,1604,1569,1556,1,1,11,0.74,2.17,96.29,0.06,0.06,0.68
21031930301,Census Tract 9303.01,1415,1368,36,32,1383,1347,1342,0,3,2,2.26,2.54,94.84,0.0,0.21,0.14
21031930302,Census Tract 9303.02,3199,3024,113,458,2741,2628,2598,8,7,15,14.32,3.53,81.21,0.25,0.22,0.47
21031930400,Census Tract 9304,1764,1712,42,34,1730,1688,1679,0,5,4,1.93,2.38,95.18,0.0,0.28,0.23
21031930500,Census Tract 9305,1276,1259,16,7,1269,1253,1244,1,5,3,0.55,1.25,97.49,0.08,0.39,0.24
21033920100,Census Tract 9201,1944,1882,48,20,1924,1876,1836,27,3,10,1.03,2.47,94.44,1.39,0.15,0.51
21033920200,Census Tract 9202,5027,4786,207,91,4936,4729,4218,455,29,27,1.81,4.12,83.91,9.05,0.58,0.54
21033920301,Census Tract 9203.01,3216,3031,167,52,3164,2997,2822,157,14,4,1.62,5.19,87.75,4.88,0.44,0.12
21033920302,Census Tract 9203.02,2462,2372,80,35,2427,2347,2314,15,7,11,1.42,3.25,93.99,0.61,0.28,0.45
21035010100,Census Tract 101,4303,4125,130,164,4139,4009,3960,20,18,11,3.81,3.02,92.03,0.46,0.42,0.26
21035010200,Census Tract 102,4516,4274,201,132,4384,4183,4101,56,9,17,2.92,4.45,90.81,1.24,0.2,0.38
21035010301,Census Tract 103.01,2492,2364,100,78,2414,2314,1981,239,78,16,3.13,4.01,79.49,9.59,3.13,0.64
21035010303,Census Tract 103.03,2930,2711,153,186,2744,2591,2336,203,41,11,6.35,5.22,79.73,6.93,1.4,0.38
21035010304,Census Tract 103.04,3617,3372,198,142,3475,3277,3069,114,59,35,3.93,5.47,84.85,3.15,1.63,0.97
21035010400,Census Tract 104,2424,2219,150,159,2265,2115,1852,214,30,19,6.56,6.19,76.4,8.83,1.24,0.78
21035010500,Census Tract 105,3263,3035,176,157,3106,2930,2681,195,38,16,4.81,5.39,82.16,5.98,1.16,0.49
21035010601,Census Tract 106.01,3029,2861,119,116,2913,2794,2600,117,63,14,3.83,3.93,85.84,3.86,2.08,0.46
21035010602,Census Tract 106.02,4063,3896,126,82,3981,3855,3679,83,75,18,2.02,3.1,90.55,2.04,1.85,0.44
21035010700,Census Tract 107,3209,3040,126,76,3133,3007,2952,36,15,4,2.37,3.93,91.99,1.12,0.47,0.12
21035010800,Census Tract 108,3257,3099,136,61,3196,3060,3024,16,7,13,1.87,4.18,92.85,0.49,0.21,0.4
21037050100,Census Tract 501,1202,1113,69,87,1115,1046,731,279,30,6,7.24,5.74,60.82,23.21,2.5,0.5
21037050400,Census Tract 504,1729,1624,74,66,1663,1589,1499,62,13,15,3.82,4.28,86.7,3.59,0.75,0.87
21037050500,Census Tract 505,2177,1945,183,222,1955,1772,1577,171,5,19,10.2,8.41,72.44,7.85,0.23,0.87
21037050600,Census Tract 506,1783,1606,142,147,1636,1494,1258,221,4,11,8.24,7.96,70.56,12.39,0.22,0.62
21037051101,Census Tract 511.01,2183,2083,83,91,2092,2009,1941,40,9,19,4.17,3.8,88.91,1.83,0.41,0.87
21037051102,Census Tract 511.02,1571,1467,81,33,1538,1457,1401,30,12,14,2.1,5.16,89.18,1.91,0.76,0.89
21037051200,Census Tract 512,1538,1459,68,76,1462,1394,1353,25,5,11,4.94,4.42,87.97,1.63,0.33,0.72
21037051300,Census Tract 513,4933,4749,156,91,4842,4686,4586,53,37,10,1.84,3.16,92.97,1.07,0.75,0.2
21037051901,Census Tract 519.01,4942,4774,153,39,4903,4750,4677,20,21,32,0.79,3.1,94.64,0.4,0.42,0.65
21037051903,Census Tract 519.03,6834,6604,194,77,6757,6563,6393,59,73,38,1.13,2.84,93.55,0.86,1.07,0.56
21037051904,Census Tract 519.04,5079,4815,225,76,5003,4778,4679,43,30,26,1.5,4.43,92.12,0.85,0.59,0.51
21037052001,Census Tract 520.01,5253,5059,180,39,5214,5034,4981,8,31,14,0.74,3.43,94.82,0.15,0.59,0.27
21037052002,Census Tract 520.02,2775,2680,80,25,2750,2670,2661,2,4,3,0.9,2.88,95.89,0.07,0.14,0.11
21037052100,Census Tract 521,3259,3089,122,101,3158,3036,2933,65,13,25,3.1,3.74,90.0,1.99,0.4,0.77
21037052200,Census Tract 522,2225,2120,83,53,2172,2089,2043,27,16,3,2.38,3.73,91.82,1.21,0.72,0.13
21037052301,Census Tract 523.01,4793,4547,203,92,4701,4498,4231,122,129,16,1.92,4.24,88.27,2.55,2.69,0.33
21037052302,Census Tract 523.02,5148,4924,157,115,5033,4876,4707,40,97,32,2.23,3.05,91.43,0.78,1.88,0.62
21037052400,Census Tract 524,2596,2464,102,73,2523,2421,2289,87,24,21,2.81,3.93,88.17,3.35,0.92,0.81
21037052500,Census Tract 525,5313,4979,285,143,5170,4885,4385,419,67,14,2.69,5.36,82.53,7.89,1.26,0.26
21037052800,Census Tract 528,3620,3425,169,112,3508,3339,3220,62,48,9,3.09,4.67,88.95,1.71,1.33,0.25
21037052900,Census Tract 529,5283,5064,188,74,5209,5021,4877,75,37,32,1.4,3.56,92.31,1.42,0.7,0.61
21037053100,Census Tract 531,5765,5550,184,79,5686,5502,5344,75,58,25,1.37,3.19,92.7,1.3,1.01,0.43
21037053200,Census Tract 532,2905,2745,107,165,2740,2633,2268,315,39,11,5.68,3.68,78.07,10.84,1.34,0.38
21037053301,Census Tract 533.01,5763,5524,207,127,5636,5429,4952,258,147,72,2.2,3.59,85.93,4.48,2.55,1.25
21037053302,Census Tract 533.02,4407,4174,192,106,4301,4109,3757,238,75,39,2.41,4.36,85.25,5.4,1.7,0.88
21039960100,Census Tract 9601,1554,1504,28,49,1505,1477,1450,2,3,22,3.15,1.8,93.31,0.13,0.19,1.42
21039960200,Census Tract 9602,1784,1696,81,57,1727,1646,1611,27,6,2,3.2,4.54,90.3,1.51,0.34,0.11
21039960300,Census Tract 9603,1488,1442,45,27,1461,1416,1382,30,1,3,1.81,3.02,92.88,2.02,0.07,0.2
21041950100,Census Tract 9501,2344,2243,80,74,2270,2190,2130,33,17,10,3.16,3.41,90.87,1.41,0.73,0.43
21041950200,Census Tract 9502,6267,5801,224,671,5596,5372,5206,119,26,21,10.71,3.57,83.07,1.9,0.41,0.34
21041950300,Census Tract 9503,2199,2109,63,50,2149,2086,2065,17,1,3,2.27,2.86,93.91,0.77,0.05,0.14
21043960100,Census Tract 9601,3311,3239,66,23,3288,3222,3203,5,4,10,0.69,1.99,96.74,0.15,0.12,0.3
21043960200,Census Tract 9602,3860,3788,69,20,3840,3771,3763,6,0,2,0.52,1.79,97.49,0.16,0.0,0.05
21043960300,Census Tract 9603,2818,2738,77,19,2799,2722,2708,3,3,8,0.67,2.73,96.1,0.11,0.11,0.28
21043960400,Census Tract 9604,1806,1772,34,8,1798,1764,1753,2,0,9,0.44,1.88,97.07,0.11,0.0,0.5
21043960500,Census Tract 9605,4246,4155,83,87,4159,4076,3884,164,14,14,2.05,1.95,91.47,3.86,0.33,0.33
21043960601,Census Tract 9606.01,1635,1595,37,5,1630,1593,1581,5,3,4,0.31,2.26,96.7,0.31,0.18,0.24
21043960602,Census Tract 9606.02,4759,4600,148,54,4705,4557,4498,21,24,14,1.13,3.11,94.52,0.44,0.5,0.29
21043960700,Census Tract 9607,4192,4091,90,38,4154,4064,4035,3,10,16,0.91,2.15,96.25,0.07,0.24,0.38
21045950100,Census Tract 9501,1243,1209,27,20,1223,1196,1192,0,2,2,1.61,2.17,95.9,0.0,0.16,0.16
21045950200,Census Tract 9502,2442,2367,63,131,2311,2248,2222,5,6,15,5.36,2.58,90.99,0.2,0.25,0.61
21045950301,Census Tract 9503.01,3067,2979,72,162,2905,2833,2765,25,19,24,5.28,2.35,90.15,0.82,0.62,0.78
21045950302,Census Tract 9503.02,3315,3205,80,109,3206,3126,3081,21,10,14,3.29,2.41,92.94,0.63,0.3,0.42
21045950400,Census Tract 9504,3217,3149,56,31,3186,3130,3093,10,7,20,0.96,1.74,96.15,0.31,0.22,0.62
21045950500,Census Tract 9505,2657,2589,52,86,2571,2519,2483,20,8,8,3.24,1.96,93.45,0.75,0.3,0.3
21047200100,Census Tract 2001,3788,3535,192,192,3596,3404,1506,1861,6,31,5.07,5.07,39.76,49.13,0.16,0.82
21047200200,Census Tract 2002,3186,2963,181,146,3040,2859,1573,1236,21,29,4.58,5.68,49.37,38.79,0.66,0.91
21047200300,Census Tract 2003,3112,2909,187,126,2986,2799,1604,1156,12,27,4.05,6.01,51.54,37.15,0.39,0.87
21047200400,Census Tract 2004,2199,2048,120,137,2062,1942,506,1414,4,18,6.23,5.46,23.01,64.3,0.18,0.82
21047200500,Census Tract 2005,4654,4312,216,332,4322,4106,3048,860,164,34,7.13,4.64,65.49,18.48,3.52,0.73
21047200600,Census Tract 2006,4934,4655,213,225,4709,4496,3464,925,81,26,4.56,4.32,70.21,18.75,1.64,0.53
21047200700,Census Tract 2007,6326,5998,237,337,5989,5752,4650,1033,35,34,5.33,3.75,73.51,16.33,0.55,0.54
21047200800,Census Tract 2008,2640,2483,135,78,2562,2427,1026,1371,5,25,2.95,5.11,38.86,51.93,0.19,0.95
21047200901,Census Tract 2009.01,2840,2700,111,79,2761,2650,2137,456,36,21,2.78,3.91,75.25,16.06,1.27,0.74
21047200902,Census Tract 2009.02,3407,3253,127,91,3316,3189,2947,195,29,18,2.67,3.73,86.5,5.72,0.85,0.53
21047201000,Census Tract 2010,2074,2000,60,48,2026,1966,1928,21,4,13,2.31,2.89,92.96,1.01,0.19,0.63
21047201100,Census Tract 2011,3643,3495,129,52,3591,3462,3337,109,7,9,1.43,3.54,91.6,2.99,0.19,0.25
21047201200,Census Tract 2012,2758,2652,91,51,2707,2616,2459,123,8,26,1.85,3.3,89.16,4.46,0.29,0.94
21047201301,Census Tract 2013.01,3336,3213,96,149,3187,3091,2697,367,4,23,4.47,2.88,80.85,11.0,0.12,0.69
21047201303,Census Tract 2013.03,4202,3686,353,540,3662,3309,2185,991,55,78,12.85,8.4,52.0,23.58,1.31,1.86
21047201304,Census Tract 2013.04,3686,3291,287,497,3189,2902,1660,1110,65,67,13.48,7.79,45.04,30.11,1.76,1.82
21047201400,Census Tract 2014,3138,2980,129,98,3040,2911,2680,154,60,17,3.12,4.11,85.4,4.91,1.91,0.54
21047201501,Census Tract 2015.01,4834,4142,386,1053,3781,3395,2593,591,84,127,21.78,7.99,53.64,12.23,1.74,2.63
21047201502,Census Tract 2015.02,3847,3401,270,759,3088,2818,2056,562,110,90,19.73,7.02,53.44,14.61,2.86,2.34
21047201503,Census Tract 2015.03,4144,3917,153,762,3382,3229,2344,686,149,50,18.39,3.69,56.56,16.55,3.6,1.21
21047980100,Census Tract 9801,0,0,0,0,0,0,0,0,0,0,,,,,,
21049020101,Census Tract 201.01,5443,5148,182,430,5013,4831,4539,242,19,31,7.9,3.34,83.39,4.45,0.35,0.57
21049020103,Census Tract 201.03,3648,3493,114,77,3571,3457,3351,76,20,10,2.11,3.12,91.86,2.08,0.55,0.27
21049020105,Census Tract 201.05,3686,3554,89,120,3566,3477,3299,143,14,21,3.26,2.41,89.5,3.88,0.38,0.57
21049020106,Census Tract 201.06,3330,3137,162,124,3206,3044,2929,98,8,9,3.72,4.86,87.96,2.94,0.24,0.27
21049020201,Census Tract 202.01,3198,3059,101,144,3054,2953,2199,740,5,9,4.5,3.16,68.76,23.14,0.16,0.28
21049020202,Census Tract 202.02,4089,3826,192,188,3901,3709,3527,158,7,17,4.6,4.7,86.26,3.86,0.17,0.42
21049020300,Census Tract 203,2507,2431,62,55,2452,2390,2367,5,8,10,2.19,2.47,94.42,0.2,0.32,0.4
21049020400,Census Tract 204,3281,3164,89,67,3214,3125,3088,9,10,18,2.04,2.71,94.12,0.27,0.3,0.55
21049020500,Census Tract 205,2866,2787,60,42,2824,2764,2709,31,11,13,1.47,2.09,94.52,1.08,0.38,0.45
21049020600,Census Tract 206,4924,4640,177,230,4694,4517,4259,133,107,18,4.67,3.59,86.49,2.7,2.17,0.37
21051950100,Census Tract 9501,1671,1632,27,30,1641,1614,1577,24,2,11,1.8,1.62,94.37,1.44,0.12,0.66
21051950201,Census Tract 9502.01,2930,2848,74,16,2914,2840,2814,8,5,13,0.55,2.53,96.04,0.27,0.17,0.44
21051950202,Census Tract 9502.02,2973,2898,72,14,2959,2887,2868,10,1,8,0.47,2.42,96.47,0.34,0.03,0.27
21051950301,Census Tract 9503.01,2488,2424,55,37,2451,2396,2311,80,0,5,1.49,2.21,92.89,3.22,0.0,0.2
21051950302,Census Tract 9503.02,3656,3588,57,168,3488,3431,2782,631,11,7,4.6,1.56,76.09,17.26,0.3,0.19
21051950400,Census Tract 9504,2952,2909,42,8,2944,2902,2898,3,0,1,0.27,1.42,98.17,0.1,0.0,0.03
21051950500,Census Tract 9505,2420,2361,42,31,2389,2347,2301,34,1,11,1.28,1.74,95.08,1.4,0.04,0.45
21051950600,Census Tract 9506,1255,1201,42,49,1206,1164,1135,26,1,2,3.9,3.35,90.44,2.07,0.08,0.16
21053970100,Census Tract 9701,2752,2679,63,35,2717,2654,2635,2,6,11,1.27,2.29,95.75,0.07,0.22,0.4
21053970202,Census Tract 9702.02,3347,3239,86,134,3213,3127,3105,11,1,10,4.0,2.57,92.77,0.33,0.03,0.3
21053970203,Census Tract 9702.03,1561,1521,39,13,1548,1509,1497,12,0,0,0.83,2.5,95.9,0.77,0.0,0.0
21053970204,Census Tract 9702.04,1593,1520,63,63,1530,1467,1443,14,3,7,3.95,3.95,90.58,0.88,0.19,0.44
21055930100,Census Tract 9301,1840,1801,28,20,1820,1792,1787,1,2,2,1.09,1.52,97.12,0.05,0.11,0.11
21055930200,Census Tract 9302,4117,3959,124,66,4051,3927,3832,67,3,25,1.6,3.01,93.08,1.63,0.07,0.61
21055930300,Census Tract 9303,1395,1370,21,13,1382,1361,1349,8,0,4,0.93,1.51,96.7,0.57,0.0,0.29
21055930400,Census Tract 9304,1638,1576,56,14,1624,1568,1556,6,0,6,0.85,3.42,94.99,0.37,0.0,0.37
21057950100,Census Tract 9501,3713,3551,145,57,3656,3511,3368,131,1,11,1.54,3.91,90.71,3.53,0.03,0.3
21057950200,Census Tract 9502,2175,2115,56,20,2155,2099,2077,19,1,2,0.92,2.57,95.49,0.87,0.05,0.09
21059000100,Census Tract 1,3335,3072,188,208,3127,2939,2266,608,32,33,6.24,5.64,67.95,18.23,0.96,0.99
21059000200,Census Tract 2,3477,3183,247,234,3243,2996,2263,682,20,31,6.73,7.1,65.08,19.61,0.58,0.89
21059000300,Census Tract 3,2018,1873,108,193,1825,1717,1392,231,84,10,9.56,5.35,68.98,11.45,4.16,0.5
21059000401,Census Tract 4.01,5546,5114,349,341,5205,4856,4430,265,129,32,6.15,6.29,79.88,4.78,2.33,0.58
21059000402,Census Tract 4.02,2247,2060,167,136,2111,1944,1713,204,13,14,6.05,7.43,76.23,9.08,0.58,0.62
21059000500,Census Tract 5,1938,1791,109,192,1746,1637,1479,120,5,33,9.91,5.62,76.32,6.19,0.26,1.7
21059000600,Census Tract 6,5810,5577,189,254,5556,5367,4876,407,66,18,4.37,3.25,83.92,7.01,1.14,0.31
21059000700,Census Tract 7,4497,4328,125,101,4396,4271,3997,130,137,7,2.25,2.78,88.88,2.89,3.05,0.16
21059000800,Census Tract 8,3823,3584,182,150,3673,3491,3063,154,254,20,3.92,4.76,80.12,4.03,6.64,0.52
21059000900,Census Tract 9,5247,4961,227,137,5110,4883,4519,177,171,16,2.61,4.33,86.13,3.37,3.26,0.3
21059001000,Census Tract 10,3240,3023,132,239,3001,2869,2431,136,292,10,7.38,4.07,75.03,4.2,9.01,0.31
21059001100,Census Tract 11,2493,2394,77,74,2419,2342,2100,164,51,27,2.97,3.09,84.24,6.58,2.05,1.08
21059001200,Census Tract 12,3308,3119,133,104,3204,3071,2802,138,117,14,3.14,4.02,84.7,4.17,3.54,0.42
21059001300,Census Tract 13,6283,5944,288,181,6102,5814,5349,330,109,26,2.88,4.58,85.13,5.25,1.73,0.41
21059001401,Census Tract 14.01,5470,5217,162,255,5215,5053,4811,171,43,28,4.66,2.96,87.95,3.13,0.79,0.51
21059001402,Census Tract 14.02,5514,5261,180,154,5360,5180,5042,70,34,34,2.79,3.26,91.44,1.27,0.62,0.62
21059001501,Census Tract 15.01,3717,3533,106,246,3471,3365,3296,43,9,17,6.62,2.85,88.67,1.16,0.24,0.46
21059001502,Census Tract 15.02,3490,3416,57,38,3452,3395,3382,6,7,0,1.09,1.63,96.91,0.17,0.2,0.0
21059001601,Census Tract 16.01,5030,4833,162,92,4938,4776,4489,89,181,17,1.83,3.22,89.24,1.77,3.6,0.34
21059001602,Census Tract 16.02,4783,4632,117,66,4717,4600,4566,17,8,9,1.38,2.45,95.46,0.36,0.17,0.19
21059001701,Census Tract 17.01,6297,5887,317,347,5950,5633,4672,443,473,45,5.51,5.03,74.19,7.04,7.51,0.71
21059001702,Census Tract 17.02,3507,3344,136,71,3436,3300,3062,95,128,15,2.02,3.88,87.31,2.71,3.65,0.43
21059001703,Census Tract 17.03,5363,5159,150,110,5253,5103,4981,61,34,27,2.05,2.8,92.88,1.14,0.63,0.5
21059001800,Census Tract 18,6879,6648,188,222,6657,6469,6346,86,20,17,3.23,2.73,92.25,1.25,0.29,0.25
21061920200,Census Tract 9202,4123,4004,103,45,4078,3975,3944,7,13,11,1.09,2.5,95.66,0.17,0.32,0.27
21061920300,Census Tract 9203,1286,1257,28,12,1274,1246,1231,5,4,6,0.93,2.18,95.72,0.39,0.31,0.47
21061920401,Census Tract 9204.01,2804,2710,71,51,2753,2682,2642,22,7,11,1.82,2.53,94.22,0.78,0.25,0.39
21061920402,Census Tract 9204.02,3809,3694,102,44,3765,3663,3632,15,2,14,1.16,2.68,95.35,0.39,0.05,0.37
21061980100,Census Tract 9801,104,99,5,4,100,95,37,49,6,3,3.85,4.81,35.58,47.12,5.77,2.88
21063920101,Census Tract 9201.01,2850,2820,28,40,2810,2782,2515,243,7,17,1.4,0.98,88.25,8.53,0.25,0.6
21063920102,Census Tract 9201.02,2638,2594,41,29,2609,2568,2554,3,2,9,1.1,1.55,96.82,0.11,0.08,0.34
21063920200,Census Tract 9202,1866,1823,34,22,1844,1810,1806,0,1,3,1.18,1.82,96.78,0.0,0.05,0.16
21065920100,Census Tract 9201,1306,1259,38,21,1285,1247,1245,2,0,0,1.61,2.91,95.33,0.15,0.0,0.0
21065920201,Census Tract 9202.01,1861,1811,45,8,1853,1808,1806,1,0,1,0.43,2.42,97.04,0.05,0.0,0.05
21065920202,Census Tract 9202.02,4175,4073,92,50,4125,4033,4010,8,0,15,1.2,2.2,96.05,0.19,0.0,0.36
21065920301,Census Tract 9203.01,1807,1747,51,16,1791,1740,1727,5,1,7,0.89,2.82,95.57,0.28,0.06,0.39
21065920302,Census Tract 9203.02,3532,3423,86,31,3501,3415,3396,7,6,6,0.88,2.43,96.15,0.2,0.17,0.17
21065920400,Census Tract 9204,1482,1450,30,5,1477,1447,1435,7,0,5,0.34,2.02,96.83,0.47,0.0,0.34
21067000101,Census Tract 1.01,3000,2754,182,187,2813,2631,1933,606,70,22,6.23,6.07,64.43,20.2,2.33,0.73
21067000102,Census Tract 1.02,1447,1375,58,43,1404,1346,1054,265,15,12,2.97,4.01,72.84,18.31,1.04,0.83
21067000200,Census Tract 2,3181,3010,136,173,3008,2872,1906,921,27,18,5.44,4.28,59.92,28.95,0.85,0.57
21067000300,Census Tract 3,2822,2560,179,255,2567,2388,1089,1273,5,21,9.04,6.34,38.59,45.11,0.18,0.74
21067000400,Census Tract 4,1847,1697,102,202,1645,1543,621,906,6,10,10.94,5.52,33.62,49.05,0.32,0.54
21067000500,Census Tract 5,3355,3170,125,124,3231,3106,2934,114,38,20,3.7,3.73,87.45,3.4,1.13,0.6
21067000600,Census Tract 6,4331,4142,129,106,4225,4096,3980,44,59,13,2.45,2.98,91.9,1.02,1.36,0.3
21067000700,Census Tract 7,2316,2190,84,92,2224,2140,1949,64,122,5,3.97,3.63,84.15,2.76,5.27,0.22
21067000801,Census Tract 8.01,3931,3915,15,242,3689,3674,3028,325,141,180,6.16,0.38,77.03,8.27,3.59,4.58
21067000802,Census Tract 8.02,4211,4122,56,221,3990,3934,3317,303,195,119,5.25,1.33,78.77,7.2,4.63,2.83
21067000900,Census Tract 9,6074,5722,218,420,5654,5436,4008,931,430,67,6.91,3.59,65.99,15.33,7.08,1.1
21067001000,Census Tract 10,1585,1438,77,147,1438,1361,924,345,87,5,9.27,4.86,58.3,21.77,5.49,0.32
21067001100,Census Tract 11,5150,4646,134,1788,3362,3228,971,2185,20,52,34.72,2.6,18.85,42.43,0.39,1.01
21067001300,Census Tract 13,1951,1771,82,450,1501,1419,906,487,6,20,23.07,4.2,46.44,24.96,0.31,1.03
21067001400,Census Tract 14,2373,2147,135,342,2031,1896,1448,403,16,29,14.41,5.69,61.02,16.98,0.67,1.22
21067001500,Census Tract 15,2116,1953,114,326,1790,1676,1341,310,8,17,15.41,5.39,63.37,14.65,0.38,0.8
21067001600,Census Tract 16,2596,2400,128,244,2352,2224,1629,538,40,17,9.4,4.93,62.75,20.72,1.54,0.65
21067001700,Census Tract 17,2147,2036,84,147,2000,1916,1746,135,19,16,6.85,3.91,81.32,6.29,0.88,0.75
21067001800,Census Tract 18,2424,2268,125,145,2279,2154,1720,170,250,14,5.98,5.16,70.96,7.01,10.31,0.58
21067001900,Census Tract 19,4794,4365,241,828,3966,3725,2389,1119,182,35,17.27,5.03,49.83,23.34,3.8,0.73
21067002001,Census Tract 20.01,5587,4837,248,2294,3293,3045,2078,897,41,29,41.06,4.44,37.19,16.06,0.73,0.52
21067002002,Census Tract 20.02,2346,2040,64,948,1398,1334,980,326,16,12,40.41,2.73,41.77,13.9,0.68,0.51
21067002200,Census Tract 22,1548,1426,83,93,1455,1372,1110,142,105,15,6.01,5.36,71.71,9.17,6.78,0.97
21067002302,Census Tract 23.02,5348,5034,215,182,5166,4951,4553,213,176,9,3.4,4.02,85.13,3.98,3.29,0.17
21067002303,Census Tract 23.03,4269,4046,156,217,4052,3896,3181,493,200,22,5.08,3.65,74.51,11.55,4.68,0.52
21067002304,Census Tract 23.04,2028,1951,55,47,1981,1926,1888,3,27,8,2.32,2.71,93.1,0.15,1.33,0.39
21067002400,Census Tract 24,4203,4023,117,196,4007,3890,3164,123,552,51,4.66,2.78,75.28,2.93,13.13,1.21
21067002500,Census Tract 25,3345,3141,124,173,3172,3048,2885,87,60,16,5.17,3.71,86.25,2.6,1.79,0.48
21067002600,Census Tract 26,5102,4690,200,620,4482,4282,3736,424,92,30,12.15,3.92,73.23,8.31,1.8,0.59
21067002700,Census Tract 27,4111,3790,180,518,3593,3413,2912,268,201,32,12.6,4.38,70.83,6.52,4.89,0.78
21067002800,Census Tract 28,3842,3617,151,180,3662,3511,3195,132,152,32,4.69,3.93,83.16,3.44,3.96,0.83
21067002900,Census Tract 29,4282,4053,182,156,4126,3944,3776,74,71,23,3.64,4.25,88.18,1.73,1.66,0.54
21067003000,Census Tract 30,5928,5456,255,774,5154,4899,4247,520,99,33,13.06,4.3,71.64,8.77,1.67,0.56
21067003101,Census Tract 31.01,2899,2671,124,397,2502,2378,1730,592,13,43,13.69,4.28,59.68,20.42,0.45,1.48
21067003102,Census Tract 31.02,2547,2382,109,264,2283,2174,1041,1092,15,26,10.37,4.28,40.87,42.87,0.59,1.02
21067003201,Census Tract 32.01,1703,1566,81,186,1517,1436,1182,244,5,5,10.92,4.76,69.41,14.33,0.29,0.29
21067003202,Census Tract 32.02,6408,5918,294,800,5608,5314,3907,1302,57,48,12.48,4.59,60.97,20.32,0.89,0.75
21067003300,Census Tract 33,2926,2739,142,275,2651,2509,1862,566,50,31,9.4,4.85,63.64,19.34,1.71,1.06
21067003402,Census Tract 34.02,4805,4425,261,443,4362,4101,2859,1021,162,59,9.22,5.43,59.5,21.25,3.37,1.23
21067003404,Census Tract 34.04,4676,4345,245,360,4316,4071,2416,1541,70,44,7.7,5.24,51.67,32.96,1.5,0.94
21067003405,Census Tract 34.05,6076,5553,403,472,5604,5201,3715,1315,120,51,7.77,6.63,61.14,21.64,1.97,0.84
21067003406,Census Tract 34.06,6754,6116,445,594,6160,5715,4734,871,62,48,8.79,6.59,70.09,12.9,0.92,0.71
21067003407,Census Tract 34.07,3847,3567,217,230,3617,3400,2539,518,312,31,5.98,5.64,66.0,13.47,8.11,0.81
21067003501,Census Tract 35.01,3872,3570,195,364,3508,3313,2590,582,125,16,9.4,5.04,66.89,15.03,3.23,0.41
21067003503,Census Tract 35.03,2646,2453,126,201,2445,2319,1770,421,107,21,7.6,4.76,66.89,15.91,4.04,0.79
21067003504,Census Tract 35.04,3770,3420,241,393,3377,3136,1941,997,146,52,10.42,6.39,51.49,26.45,3.87,1.38
21067003600,Census Tract 36,4427,4249,137,88,4339,4202,3988,87,111,16,1.99,3.09,90.08,1.97,2.51,0.36
21067003701,Census Tract 37.01,2895,2785,45,294,2601,2556,1858,654,27,17,10.16,1.55,64.18,22.59,0.93,0.59
21067003702,Census Tract 37.02,4697,4235,261,563,4134,3873,2630,1108,119,16,11.99,5.56,55.99,23.59,2.53,0.34
21067003703,Census Tract 37.03,5309,4873,253,409,4900,4647,3443,1046,123,35,7.7,4.77,64.85,19.7,2.32,0.66
21067003704,Census Tract 37.04,7431,6822,375,686,6745,6370,4146,1852,335,37,9.23,5.05,55.79,24.92,4.51,0.5
21067003802,Census Tract 38.02,2048,1823,61,543,1505,1444,1342,80,14,8,26.51,2.98,65.53,3.91,0.68,0.39
21067003803,Census Tract 38.03,3494,3206,185,406,3088,2903,1793,1027,44,39,11.62,5.29,51.32,29.39,1.26,1.12
21067003804,Census Tract 38.04,6479,5985,163,1958,4521,4358,813,3462,26,57,30.22,2.52,12.55,53.43,0.4,0.88
21067003906,Census Tract 39.06,4583,4337,192,138,4445,4253,3785,264,188,16,3.01,4.19,82.59,5.76,4.1,0.35
21067003908,Census Tract 39.08,6983,6506,323,381,6602,6279,4909,772,551,47,5.46,4.63,70.3,11.06,7.89,0.67
21067003909,Census Tract 39.09,3207,2900,197,439,2768,2571,1735,721,90,25,13.69,6.14,54.1,22.48,2.81,0.78
21067003910,Census Tract 39.10,2863,2583,157,575,2288,2131,939,1103,78,11,20.08,5.48,32.8,38.53,2.72,0.38
21067003911,Census Tract 39.11,3815,3462,256,622,3193,2937,1749,1056,111,21,16.3,6.71,45.85,27.68,2.91,0.55
21067003912,Census Tract 39.12,4352,4073,201,205,4147,3946,2878,767,281,20,4.71,4.62,66.13,17.62,6.46,0.46
21067003913,Census Tract 39.13,8762,8205,408,308,8454,8046,6426,549,1047,24,3.52,4.66,73.34,6.27,11.95,0.27
21067003914,Census Tract 39.14,2482,2314,115,115,2367,2252,1447,544,241,20,4.63,4.63,58.3,21.92,9.71,0.81
21067003915,Census Tract 39.15,4734,4438,223,172,4562,4339,3538,455,312,34,3.63,4.71,74.74,9.61,6.59,0.72
21067003916,Census Tract 39.16,591,565,18,21,570,552,512,12,28,0,3.55,3.05,86.63,2.03,4.74,0.0
21067003917,Census Tract 39.17,1751,1589,76,232,1519,1443,1043,344,52,4,13.25,4.34,59.57,19.65,2.97,0.23
21067003918,Census Tract 39.18,3065,2896,113,208,2857,2744,2480,179,65,20,6.79,3.69,80.91,5.84,2.12,0.65
21067004001,Census Tract 40.01,6633,5976,450,627,6006,5556,3733,1597,194,32,9.45,6.78,56.28,24.08,2.92,0.48
21067004003,Census Tract 40.03,5331,4990,277,241,5090,4813,4141,538,97,37,4.52,5.2,77.68,10.09,1.82,0.69
21067004005,Census Tract 40.05,1636,1525,75,53,1583,1508,1424,64,19,1,3.24,4.58,87.04,3.91,1.16,0.06
21067004006,Census Tract 40.06,1326,1274,39,34,1292,1253,1183,37,29,4,2.56,2.94,89.22,2.79,2.19,0.3
21067004007,Census Tract 40.07,1808,1714,57,80,1728,1671,1617,24,16,14,4.42,3.15,89.44,1.33,0.88,0.77
21067004103,Census Tract 41.03,1923,1789,88,128,1795,1707,1337,158,204,8,6.66,4.58,69.53,8.22,10.61,0.42
21067004104,Census Tract 41.04,4399,4031,231,439,3960,3729,2938,700,65,26,9.98,5.25,66.79,15.91,1.48,0.59
21067004105,Census Tract 41.05,5364,5044,233,223,5141,4908,4328,301,249,30,4.16,4.34,80.69,5.61,4.64,0.56
21067004106,Census Tract 41.06,4541,4278,191,136,4405,4214,3649,267,261,37,2.99,4.21,80.36,5.88,5.75,0.81
21067004107,Census Tract 41.07,5374,5063,233,167,5207,4974,4360,307,287,20,3.11,4.34,81.13,5.71,5.34,0.37
21067004204,Census Tract 42.04,5883,5499,253,320,5563,5310,4722,222,348,18,5.44,4.3,80.27,3.77,5.92,0.31
21067004205,Census Tract 42.05,7062,6640,284,269,6793,6509,5942,224,328,15,3.81,4.02,84.14,3.17,4.64,0.21
21067004207,Census Tract 42.07,3873,3685,128,111,3762,3634,3221,114,270,29,2.87,3.3,83.17,2.94,6.97,0.75
21067004208,Census Tract 42.08,7565,7148,278,248,7317,7039,5309,169,1532,29,3.28,3.67,70.18,2.23,20.25,0.38
21067004209,Census Tract 42.09,3954,3713,156,146,3808,3652,3351,152,138,11,3.69,3.95,84.75,3.84,3.49,0.28
21067004210,Census Tract 42.10,5411,4995,273,306,5105,4832,3750,337,722,23,5.66,5.05,69.3,6.23,13.34,0.43
21069920100,Census Tract 9201,4443,4314,107,112,4331,4224,4115,85,5,19,2.52,2.41,92.62,1.91,0.11,0.43
21069920200,Census Tract 9202,3278,3212,51,31,3247,3196,3149,23,2,22,0.95,1.56,96.06,0.7,0.06,0.67
21069920300,Census Tract 9203,2698,2622,71,17,2681,2610,2572,28,0,10,0.63,2.63,95.33,1.04,0.0,0.37
21069920400,Census Tract 9204,4663,4564,89,58,4605,4516,4478,12,10,16,1.24,1.91,96.03,0.26,0.21,0.34
21071920100,Census Tract 9201,3481,3390,70,59,3422,3352,3288,15,44,5,1.69,2.01,94.46,0.43,1.26,0.14
21071920200,Census Tract 9202,1863,1823,35,14,1849,1814,1805,2,1,6,0.75,1.88,96.89,0.11,0.05,0.32
21071920301,Census Tract 9203.01,2325,2266,53,22,2303,2250,2231,9,8,2,0.95,2.28,95.96,0.39,0.34,0.09
21071920302,Census Tract 9203.02,2276,2248,21,19,2257,2236,2216,12,3,5,0.83,0.92,97.36,0.53,0.13,0.22
21071920401,Census Tract 9204.01,2719,2683,36,15,2704,2668,2657,6,2,3,0.55,1.32,97.72,0.22,0.07,0.11
21071920402,Census Tract 9204.02,1704,1670,28,30,1674,1646,1632,5,3,6,1.76,1.64,95.77,0.29,0.18,0.35
21071920500,Census Tract 9205,2599,2529,69,14,2585,2516,2485,20,3,8,0.54,2.65,95.61,0.77,0.12,0.31
21071920600,Census Tract 9206,2706,2646,60,10,2696,2636,2613,13,8,2,0.37,2.22,96.56,0.48,0.3,0.07
21071920700,Census Tract 9207,2622,2533,78,24,2598,2520,2513,2,0,5,0.92,2.97,95.84,0.08,0.0,0.19
21071920801,Census Tract 9208.01,2593,2537,46,30,2563,2517,2495,11,3,8,1.16,1.77,96.22,0.42,0.12,0.31
21071920802,Census Tract 9208.02,2374,2312,59,11,2363,2304,2292,7,1,4,0.46,2.49,96.55,0.29,0.04,0.17
21071920900,Census Tract 9209,1830,1797,29,11,1819,1790,1787,1,1,1,0.6,1.58,97.65,0.05,0.05,0.05
21071921001,Census Tract 9210.01,3518,3452,59,28,3490,3431,3404,13,9,5,0.8,1.68,96.76,0.37,0.26,0.14
21071921002,Census Tract 9210.02,3332,3269,57,21,3311,3254,3236,5,10,3,0.63,1.71,97.12,0.15,0.3,0.09
21073070101,Census Tract 701.01,3127,2912,175,231,2896,2721,2138,535,21,27,7.39,5.6,68.37,17.11,0.67,0.86
21073070102,Census Tract 701.02,3324,3105,170,170,3154,2984,2375,523,61,25,5.11,5.11,71.45,15.73,1.84,0.75
21073070401,Census Tract 704.01,2639,2470,117,95,2544,2427,2090,261,61,15,3.6,4.43,79.2,9.89,2.31,0.57
21073070403,Census Tract 704.03,1766,1592,121,135,1631,1510,1299,168,34,9,7.64,6.85,73.56,9.51,1.93,0.51
21073070404,Census Tract 704.04,2772,2601,145,89,2683,2538,2260,255,12,11,3.21,5.23,81.53,9.2,0.43,0.4
21073070405,Census Tract 704.05,1814,1688,85,91,1723,1638,1192,154,275,17,5.02,4.69,65.71,8.49,15.16,0.94
21073070500,Census Tract 705,2070,1918,132,53,2017,1885,1608,243,11,23,2.56,6.38,77.68,11.74,0.53,1.11
21073070601,Census Tract 706.01,2107,1966,103,131,1976,1873,1455,404,6,8,6.22,4.89,69.06,19.17,0.28,0.38
21073070602,Census Tract 706.02,2268,2077,153,122,2146,1993,1575,377,15,26,5.38,6.75,69.44,16.62,0.66,1.15
21073070703,Census Tract 707.03,2226,2107,68,93,2133,2065,1647,189,225,4,4.18,3.05,73.99,8.49,10.11,0.18
21073070704,Census Tract 707.04,2227,2081,109,96,2131,2022,1731,235,34,22,4.31,4.89,77.73,10.55,1.53,0.99
21073070705,Census Tract 707.05,2142,2049,66,47,2095,2029,1928,48,48,5,2.19,3.08,90.01,2.24,2.24,0.23
21073070706,Census Tract 707.06,3168,2939,172,182,2986,2814,2378,349,62,25,5.74,5.43,75.06,11.02,1.96,0.79
21073070801,Census Tract 708.01,2755,2652,95,46,2709,2614,2558,40,9,7,1.67,3.45,92.85,1.45,0.33,0.25
21073070802,Census Tract 708.02,2033,1942,78,55,1978,1900,1782,81,30,7,2.71,3.84,87.65,3.98,1.48,0.34
21073071001,Census Tract 710.01,3112,2976,121,58,3054,2933,2807,79,32,15,1.86,3.89,90.2,2.54,1.03,0.48
21073071002,Census Tract 710.02,2705,2572,104,82,2623,2519,2367,130,10,12,3.03,3.84,87.5,4.81,0.37,0.44
21073071101,Census Tract 711.01,2516,2430,82,35,2481,2399,2356,14,7,22,1.39,3.26,93.64,0.56,0.28,0.87
21073071102,Census Tract 711.02,3875,3714,130,97,3778,3648,3456,103,74,15,2.5,3.35,89.19,2.66,1.91,0.39
21073071200,Census Tract 712,2895,2648,194,139,2756,2562,2280,256,4,22,4.8,6.7,78.76,8.84,0.14,0.76
21075960100,Census Tract 9601,3567,3354,193,71,3496,3303,2590,660,16,37,1.99,5.41,72.61,18.5,0.45,1.04
21075960200,Census Tract 9602,2948,2814,104,80,2868,2764,1976,773,1,14,2.71,3.53,67.03,26.22,0.03,0.47
21077960102,Census Tract 9601.02,2468,2326,103,91,2377,2274,2250,11,3,10,3.69,4.17,91.17,0.45,0.12,0.41
21077960103,Census Tract 9601.03,2381,2229,98,252,2129,2031,1986,32,5,8,10.58,4.12,83.41,1.34,0.21,0.34
21077960104,Census Tract 9601.04,3841,3683,126,149,3692,3566,3526,31,5,4,3.88,3.28,91.8,0.81,0.13,0.1
21079970101,Census Tract 9701.01,2929,2791,118,68,2861,2743,2715,15,7,6,2.32,4.03,92.69,0.51,0.24,0.2
21079970102,Census Tract 9701.02,3306,3144,114,78,3228,3114,3069,19,17,9,2.36,3.45,92.83,0.57,0.51,0.27
21079970201,Census Tract 9702.01,3046,2863,154,79,2967,2813,2701,82,14,16,2.59,5.06,88.67,2.69,0.46,0.53
21079970202,Census Tract 9702.02,1208,1148,47,30,1178,1131,1124,6,1,0,2.48,3.89,93.05,0.5,0.08,0.0
21079970300,Census Tract 9703,3310,3186,101,123,3187,3086,2885,163,7,31,3.72,3.05,87.16,4.92,0.21,0.94
21079970400,Census Tract 9704,3154,3023,111,73,3081,2970,2939,16,5,10,2.31,3.52,93.18,0.51,0.16,0.32
21081920101,Census Tract 9201.01,5550,5253,214,170,5380,5166,5083,50,17,16,3.06,3.86,91.59,0.9,0.31,0.29
21081920102,Census Tract 9201.02,2922,2723,135,152,2770,2635,2567,18,9,41,5.2,4.62,87.85,0.62,0.31,1.4
21081920201,Census Tract 9202.01,2947,2861,76,43,2904,2828,2787,14,13,14,1.46,2.58,94.57,0.48,0.44,0.48
21081920202,Census Tract 9202.02,4249,4007,205,203,4046,3841,3766,29,7,39,4.78,4.82,88.63,0.68,0.16,0.92
21081920301,Census Tract 9203.01,1886,1817,58,27,1859,1801,1790,4,1,6,1.43,3.08,94.91,0.21,0.05,0.32
21081920302,Census Tract 9203.02,5218,4944,220,129,5089,4869,4792,48,12,17,2.47,4.22,91.84,0.92,0.23,0.33
21081920400,Census Tract 9204,2169,2071,84,17,2152,2068,2038,16,7,7,0.78,3.87,93.96,0.74,0.32,0.32
21083020100,Census Tract 201,4050,3755,214,500,3550,3336,2896,395,24,21,12.35,5.28,71.51,9.75,0.59,0.52
21083020200,Census Tract 202,4391,4044,217,409,3982,3765,3261,434,53,17,9.31,4.94,74.27,9.88,1.21,0.39
21083020301,Census Tract 203.01,4721,4288,203,720,4001,3798,3453,284,29,32,15.25,4.3,73.14,6.02,0.61,0.68
21083020302,Census Tract 203.02,1857,1704,89,409,1448,1359,1119,229,3,8,22.02,4.79,60.26,12.33,0.16,0.43
21083020400,Census Tract 204,2709,2560,83,102,2607,2524,2492,16,4,12,3.77,3.06,91.99,0.59,0.15,0.44
21083020500,Census Tract 205,3708,3529,145,106,3602,3457,3354,77,14,12,2.86,3.91,90.45,2.08,0.38,0.32
21083020600,Census Tract 206,2307,2249,51,36,2271,2220,2197,16,4,3,1.56,2.21,95.23,0.69,0.17,0.13
21083020700,Census Tract 207,4969,4769,129,267,4702,4573,4460,56,22,35,5.37,2.6,89.76,1.13,0.44,0.7
21083020800,Census Tract 208,4915,4696,181,113,4802,4621,4560,24,13,24,2.3,3.68,92.78,0.49,0.26,0.49
21083020900,Census Tract 209,3022,2853,138,111,2911,2773,2735,20,7,11,3.67,4.57,90.5,0.66,0.23,0.36
21085950101,Census Tract 9501.01,811,790,21,2,809,788,784,3,0,1,0.25,2.59,96.67,0.37,0.0,0.12
21085950102,Census Tract 9501.02,2281,2215,56,17,2264,2208,2202,3,3,0,0.75,2.46,96.54,0.13,0.13,0.0
21085950200,Census Tract 9502,2944,2840,93,46,2898,2805,2772,5,11,17,1.56,3.16,94.16,0.17,0.37,0.58
21085950300,Census Tract 9503,4089,4008,64,75,4014,3950,3723,196,7,24,1.83,1.57,91.05,4.79,0.17,0.59
21085950401,Census Tract 9504.01,2327,2237,73,50,2277,2204,2136,26,21,21,2.15,3.14,91.79,1.12,0.9,0.9
21085950402,Census Tract 9504.02,4870,4657,175,79,4791,4616,4515,41,29,31,1.62,3.59,92.71,0.84,0.6,0.64
21085950500,Census Tract 9505,2788,2708,76,21,2767,2691,2651,7,7,26,0.75,2.73,95.09,0.25,0.25,0.93
21085950600,Census Tract 9506,3823,3694,113,41,3782,3669,3633,13,7,16,1.07,2.96,95.03,0.34,0.18,0.42
21085950700,Census Tract 9507,2487,2394,77,33,2454,2377,2340,14,11,12,1.33,3.1,94.09,0.56,0.44,0.48
21087930100,Census Tract 9301,2999,2917,72,56,2943,2871,2823,31,11,6,1.87,2.4,94.13,1.03,0.37,0.2
21087930200,Census Tract 9302,4120,3958,148,74,4046,3898,3776,100,12,10,1.8,3.59,91.65,2.43,0.29,0.24
21087930300,Census Tract 9303,2406,2333,61,39,2367,2306,2273,9,2,22,1.62,2.54,94.47,0.37,0.08,0.91
21087930400,Census Tract 9304,1582,1547,31,30,1552,1521,1489,20,3,9,1.9,1.96,94.12,1.26,0.19,0.57
21089040100,Census Tract 401,4495,4349,122,56,4439,4317,4169,29,108,11,1.25,2.71,92.75,0.65,2.4,0.24
21089040201,Census Tract 402.01,3050,2942,101,21,3029,2928,2878,23,14,13,0.69,3.31,94.36,0.75,0.46,0.43
21089040202,Census Tract 402.02,4447,4232,195,44,4403,4208,4127,21,34,26,0.99,4.38,92.8,0.47,0.76,0.58
21089040300,Census Tract 403,4275,4127,135,27,4248,4113,4048,31,18,16,0.63,3.16,94.69,0.73,0.42,0.37
21089040400,Census Tract 404,5647,5500,128,49,5598,5470,5406,21,20,23,0.87,2.27,95.73,0.37,0.35,0.41
21089040501,Census Tract 405.01,3233,3122,105,11,3222,3117,3073,6,20,18,0.34,3.25,95.05,0.19,0.62,0.56
21089040502,Census Tract 405.02,4677,4562,102,43,4634,4532,4425,80,5,22,0.92,2.18,94.61,1.71,0.11,0.47
21089040600,Census Tract 406,2728,2620,100,18,2710,2610,2579,6,6,19,0.66,3.67,94.54,0.22,0.22,0.7
21089040700,Census Tract 407,3410,3316,78,48,3362,3284,3269,2,5,8,1.41,2.29,95.87,0.06,0.15,0.23
21091960100,Census Tract 9601,2746,2664,70,33,2713,2643,2605,23,10,5,1.2,2.55,94.87,0.84,0.36,0.18
21091960200,Census Tract 9602,3732,3597,91,100,3632,3541,3460,54,15,12,2.68,2.44,92.71,1.45,0.4,0.32
21091960300,Census Tract 9603,2617,2548,55,29,2588,2533,2521,2,9,1,1.11,2.1,96.33,0.08,0.34,0.04
21093000100,Census Tract 1,978,913,54,21,957,903,879,19,1,4,2.15,5.52,89.88,1.94,0.1,0.41
21093000201,Census Tract 2.01,1737,1581,102,327,1410,1308,974,220,84,30,18.83,5.87,56.07,12.67,4.84,1.73
21093000202,Census Tract 2.02,3399,2920,266,605,2794,2528,1722,610,100,96,17.8,7.83,50.66,17.95,2.94,2.82
21093000300,Census Tract 3,4630,4072,397,431,4199,3802,2539,1046,141,76,9.31,8.57,54.84,22.59,3.05,1.64
21093000400,Census Tract 4,5045,4338,478,500,4545,4067,2654,1204,115,94,9.91,9.47,52.61,23.87,2.28,1.86
21093000500,Census Tract 5,2168,1905,190,187,1981,1791,1246,432,55,58,8.63,8.76,57.47,19.93,2.54,2.68
21093000600,Census Tract 6,3536,3068,341,286,3250,2909,1834,901,88,86,8.09,9.64,51.87,25.48,2.49,2.43
21093000700,Census Tract 7,4888,4385,351,382,4506,4155,2971,1000,91,93,7.82,7.18,60.78,20.46,1.86,1.9
21093000800,Census Tract 8,5673,5076,433,386,5287,4854,3555,1017,191,91,6.8,7.63,62.67,17.93,3.37,1.6
21093000902,Census Tract 9.02,4744,4257,328,380,4364,4036,2770,1007,140,119,8.01,6.91,58.39,21.23,2.95,2.51
21093000903,Census Tract 9.03,5045,4658,281,249,4796,4515,4079,318,61,57,4.94,5.57,80.85,6.3,1.21,1.13
21093000904,Census Tract 9.04,7019,6512,378,335,6684,6306,5524,610,104,68,4.77,5.39,78.7,8.69,1.48,0.97
21093001003,Census Tract 10.03,4965,4688,214,153,4812,4598,4426,91,45,36,3.08,4.31,89.14,1.83,0.91,0.73
21093001004,Census Tract 10.04,3872,3648,173,105,3767,3594,3449,110,25,10,2.71,4.47,89.08,2.84,0.65,0.26
21093001005,Census Tract 10.05,3326,3051,171,249,3077,2906,2376,396,94,40,7.49,5.14,71.44,11.91,2.83,1.2
21093001006,Census Tract 10.06,3606,3400,148,138,3468,3320,3013,146,120,41,3.83,4.1,83.56,4.05,3.33,1.14
21093001100,Census Tract 11,4117,3737,293,239,3878,3585,2933,482,136,34,5.81,7.12,71.24,11.71,3.3,0.83
21093001200,Census Tract 12,5568,5146,300,278,5290,4990,4218,533,191,48,4.99,5.39,75.75,9.57,3.43,0.86
21093001300,Census Tract 13,5255,4859,288,276,4979,4691,4014,457,168,52,5.25,5.48,76.38,8.7,3.2,0.99
21093001401,Census Tract 14.01,4163,3873,220,151,4012,3792,3349,304,98,41,3.63,5.28,80.45,7.3,2.35,0.98
21093001402,Census Tract 14.02,4421,3995,342,255,4166,3824,3279,467,37,41,5.77,7.74,74.17,10.56,0.84,0.93
21093001500,Census Tract 15,2954,2677,209,229,2725,2516,1790,625,62,39,7.75,7.08,60.6,21.16,2.1,1.32
21093001601,Census Tract 16.01,2948,2741,153,137,2811,2658,2424,205,10,19,4.65,5.19,82.23,6.95,0.34,0.64
21093001602,Census Tract 16.02,3899,3758,124,44,3855,3731,3691,20,6,14,1.13,3.18,94.67,0.51,0.15,0.36
21093001603,Census Tract 16.03,2800,2634,133,62,2738,2605,2494,80,17,14,2.21,4.75,89.07,2.86,0.61,0.5
21093001701,Census Tract 17.01,5208,4925,210,129,5079,4869,4728,85,31,25,2.48,4.03,90.78,1.63,0.6,0.48
21093001702,Census Tract 17.02,4260,4038,200,69,4191,3991,3909,27,15,40,1.62,4.69,91.76,0.63,0.35,0.94
21093980100,Census Tract 9801,478,447,17,92,386,369,245,98,17,9,19.25,3.56,51.26,20.5,3.56,1.88
21095970100,Census Tract 9701,1521,1458,50,29,1492,1442,1326,109,1,6,1.91,3.29,87.18,7.17,0.07,0.39
21095970200,Census Tract 9702,3175,3041,129,29,3146,3017,2885,107,12,13,0.91,4.06,90.87,3.37,0.38,0.41
21095970300,Census Tract 9703,1414,1369,37,11,1403,1366,1351,5,4,6,0.78,2.62,95.54,0.35,0.28,0.42
21095970400,Census Tract 9704,1035,992,35,13,1022,987,977,1,4,5,1.26,3.38,94.4,0.1,0.39,0.48
21095970500,Census Tract 9705,1284,1239,41,9,1275,1234,1230,4,0,0,0.7,3.19,95.79,0.31,0.0,0.0
21095970600,Census Tract 9706,2712,2615,94,12,2700,2606,2596,3,1,6,0.44,3.47,95.72,0.11,0.04,0.22
21095970700,Census Tract 9707,3611,3506,91,36,3575,3484,3422,38,9,15,1.0,2.52,94.77,1.05,0.25,0.42
21095970800,Census Tract 9708,1111,1042,58,14,1097,1039,984,36,13,6,1.26,5.22,88.57,3.24,1.17,0.54
21095970900,Census Tract 9709,4195,4049,133,62,4133,4000,3799,143,36,22,1.48,3.17,90.56,3.41,0.86,0.52
21095971000,Census Tract 9710,4249,4127,116,35,4214,4098,3986,88,4,20,0.82,2.73,93.81,2.07,0.09,0.47
21095971300,Census Tract 9713,2524,2466,53,15,2509,2456,2445,7,1,3,0.59,2.1,96.87,0.28,0.04,0.12
21097950100,Census Tract 9501,2671,2530,128,32,2639,2511,2498,0,0,13,1.2,4.79,93.52,0.0,0.0,0.49
21097950200,Census Tract 9502,2390,2288,85,51,2339,2254,2227,2,5,20,2.13,3.56,93.18,0.08,0.21,0.84
21097950300,Census Tract 9503,5713,5540,149,102,5611,5462,5326,98,17,21,1.79,2.61,93.23,1.72,0.3,0.37
21097950400,Census Tract 9504,3063,2908,129,108,2955,2826,2709,108,6,3,3.53,4.21,88.44,3.53,0.2,0.1
21097950500,Census Tract 9505,4855,4648,171,94,4761,4590,4456,99,18,17,1.94,3.52,91.78,2.04,0.37,0.35
21099970100,Census Tract 9701,1939,1853,74,35,1904,1830,1814,4,2,10,1.81,3.82,93.55,0.21,0.1,0.52
21099970200,Census Tract 9702,3161,3057,74,48,3113,3039,2968,45,11,15,1.52,2.34,93.89,1.42,0.35,0.47
21099970301,Census Tract 9703.01,1574,1521,46,19,1555,1509,1506,1,2,0,1.21,2.92,95.68,0.06,0.13,0.0
21099970302,Census Tract 9703.02,3633,3509,106,69,3564,3458,3289,158,11,0,1.9,2.92,90.53,4.35,0.3,0.0
21099970400,Census Tract 9704,5061,4784,232,106,4955,4723,4286,385,18,34,2.09,4.58,84.69,7.61,0.36,0.67
21099970500,Census Tract 9705,3920,3785,111,57,3863,3752,3629,112,1,10,1.45,2.83,92.58,2.86,0.03,0.26
21101020101,Census Tract 201.01,1645,1539,87,64,1581,1494,1230,242,2,20,3.89,5.29,74.77,14.71,0.12,1.22
21101020200,Census Tract 202,1702,1552,122,135,1567,1445,1223,210,6,6,7.93,7.17,71.86,12.34,0.35,0.35
21101020300,Census Tract 203,1589,1446,105,130,1459,1354,922,397,12,23,8.18,6.61,58.02,24.98,0.76,1.45
21101020401,Census Tract 204.01,2297,2100,177,117,2180,2003,1574,404,13,12,5.09,7.71,68.52,17.59,0.57,0.52
21101020501,Census Tract 205.01,2516,2366,123,122,2394,2271,1889,350,11,21,4.85,4.89,75.08,13.91,0.44,0.83
21101020602,Census Tract 206.02,4998,4758,194,160,4838,4644,3895,674,28,47,3.2,3.88,77.93,13.49,0.56,0.94
21101020603,Census Tract 206.03,2123,2070,48,21,2102,2054,1936,95,12,11,0.99,2.26,91.19,4.47,0.57,0.52
21101020604,Census Tract 206.04,4170,3876,237,177,3993,3756,3285,410,35,26,4.24,5.68,78.78,9.83,0.84,0.62
21101020701,Census Tract 207.01,5575,5263,241,174,5401,5160,4695,384,52,29,3.12,4.32,84.22,6.89,0.93,0.52
21101020703,Census Tract 207.03,3288,3138,131,43,3245,3114,2957,108,38,11,1.31,3.98,89.93,3.28,1.16,0.33
21101020704,Census Tract 207.04,3307,3195,105,40,3267,3162,3091,43,6,22,1.21,3.18,93.47,1.3,0.18,0.67
21101020800,Census Tract 208,4393,4262,112,82,4311,4199,4125,42,14,18,1.87,2.55,93.9,0.96,0.32,0.41
21101020901,Census Tract 209.01,3892,3719,157,65,3827,3670,3529,112,3,26,1.67,4.03,90.67,2.88,0.08,0.67
21101020902,Census Tract 209.02,3298,3176,106,38,3260,3154,2972,161,7,14,1.15,3.21,90.12,4.88,0.21,0.42
21103090100,Census Tract 901,2772,2636,108,68,2704,2596,2548,25,3,20,2.45,3.9,91.92,0.9,0.11,0.72
21103090200,Census Tract 902,3206,3073,117,67,3139,3022,2951,56,7,8,2.09,3.65,92.05,1.75,0.22,0.25
21103090301,Census Tract 903.01,2991,2863,91,102,2889,2798,2730,35,10,23,3.41,3.04,91.27,1.17,0.33,0.77
21103090302,Census Tract 903.02,3818,3577,193,239,3579,3386,3129,221,12,24,6.26,5.06,81.95,5.79,0.31,0.63
21103090400,Census Tract 904,2891,2794,85,69,2822,2737,2707,12,3,15,2.39,2.94,93.64,0.42,0.1,0.52
21105970100,Census Tract 9701,4521,4331,155,102,4419,4264,3866,380,11,7,2.26,3.43,85.51,8.41,0.24,0.15
21107970100,Census Tract 9701,3008,2871,108,47,2961,2853,2803,26,8,16,1.56,3.59,93.18,0.86,0.27,0.53
21107970200,Census Tract 9702,3455,3341,93,57,3398,3305,3221,48,13,23,1.65,2.69,93.23,1.39,0.38,0.67
21107970301,Census Tract 9703.01,1885,1752,101,50,1835,1734,1547,167,15,5,2.65,5.36,82.07,8.86,0.8,0.27
21107970302,Census Tract 9703.02,5226,4967,220,114,5112,4892,4368,430,74,20,2.18,4.21,83.58,8.23,1.42,0.38
21107970400,Census Tract 9704,2062,1915,135,69,1993,1858,1400,442,5,11,3.35,6.55,67.9,21.44,0.24,0.53
21107970500,Census Tract 9705,5071,4750,253,189,4882,4629,4120,447,18,44,3.73,4.99,81.25,8.81,0.35,0.87
21107970600,Census Tract 9706,3205,2990,179,189,3016,2837,2217,584,13,23,5.9,5.59,69.17,18.22,0.41,0.72
21107970700,Census Tract 9707,4798,4560,199,79,4719,4520,4208,230,64,18,1.65,4.15,87.7,4.79,1.33,0.38
21107970800,Census Tract 9708,2949,2780,144,111,2838,2694,2512,157,8,17,3.76,4.88,85.18,5.32,0.27,0.58
21107970900,Census Tract 9709,3205,3074,116,75,3130,3014,2713,289,4,8,2.34,3.62,84.65,9.02,0.12,0.25
21107971000,Census Tract 9710,2674,2591,71,38,2636,2565,2549,11,0,5,1.42,2.66,95.33,0.41,0.0,0.19
21107971100,Census Tract 9711,3068,2945,113,53,3015,2902,2872,18,3,9,1.73,3.68,93.61,0.59,0.1,0.29
21107971300,Census Tract 9713,4817,4641,161,55,4762,4601,4524,53,5,19,1.14,3.34,93.92,1.1,0.1,0.39
21109960101,Census Tract 9601.01,3091,3036,52,23,3068,3016,3001,6,1,8,0.74,1.68,97.09,0.19,0.03,0.26
21109960102,Census Tract 9601.02,1666,1640,22,8,1658,1636,1625,0,3,8,0.48,1.32,97.54,0.0,0.18,0.48
21109960200,Census Tract 9602,2729,2648,74,33,2696,2622,2610,0,6,6,1.21,2.71,95.64,0.0,0.22,0.22
21109960301,Census Tract 9603.01,3336,3264,70,16,3320,3250,3218,6,5,21,0.48,2.1,96.46,0.18,0.15,0.63
21109960302,Census Tract 9603.02,2133,2076,50,16,2117,2067,2055,0,4,8,0.75,2.34,96.34,0.0,0.19,0.38
21111000201,Census Tract 2.01,1392,1307,65,36,1356,1291,854,415,2,20,2.59,4.67,61.35,29.81,0.14,1.44
21111000202,Census Tract 2.02,1141,1100,39,7,1134,1095,794,288,1,12,0.61,3.42,69.59,25.24,0.09,1.05
21111000300,Census Tract 3,2437,2292,129,50,2387,2258,1001,1243,3,11,2.05,5.29,41.08,51.01,0.12,0.45
21111000400,Census Tract 4,4360,4180,152,54,4306,4154,923,3193,0,38,1.24,3.49,21.17,73.23,0.0,0.87
21111000600,Census Tract 6,1671,1602,54,40,1631,1577,98,1461,2,16,2.39,3.23,5.86,87.43,0.12,0.96
21111000700,Census Tract 7,2414,2341,61,55,2359,2298,148,2124,11,15,2.28,2.53,6.13,87.99,0.46,0.62
21111000800,Census Tract 8,2019,1917,93,33,1986,1893,111,1764,0,18,1.63,4.61,5.5,87.37,0.0,0.89
21111000900,Census Tract 9,2003,1939,51,46,1957,1906,89,1801,1,15,2.3,2.55,4.44,89.92,0.05,0.75
21111001000,Census Tract 10,2481,2366,102,41,2440,2338,152,2159,2,25,1.65,4.11,6.13,87.02,0.08,1.01
21111001100,Census Tract 11,3216,3071,131,70,3146,3015,172,2801,2,40,2.18,4.07,5.35,87.1,0.06,1.24
21111001200,Census Tract 12,2769,2662,84,50,2719,2635,104,2498,3,30,1.81,3.03,3.76,90.21,0.11,1.08
21111001400,Census Tract 14,2669,2588,77,26,2643,2566,35,2515,9,7,0.97,2.88,1.31,94.23,0.34,0.26
21111001500,Census Tract 15,2988,2864,105,62,2926,2821,155,2631,5,30,2.07,3.51,5.19,88.05,0.17,1.0
21111001600,Census Tract 16,2711,2552,134,97,2614,2480,207,2248,8,17,3.58,4.94,7.64,82.92,0.3,0.63
21111001700,Census Tract 17,2234,2146,79,45,2189,2110,120,1974,1,15,2.01,3.54,5.37,88.36,0.04,0.67
21111001800,Census Tract 18,1201,1149,40,21,1180,1140,72,1059,0,9,1.75,3.33,6.0,88.18,0.0,0.75
21111002100,Census Tract 21,2193,2058,123,38,2155,2032,1250,748,3,31,1.73,5.61,57.0,34.11,0.14,1.41
21111002300,Census Tract 23,2086,1943,139,23,2063,1924,1036,863,12,13,1.1,6.66,49.66,41.37,0.58,0.62
21111002401,Census Tract 24.01,2042,1971,59,46,1996,1937,224,1689,0,24,2.25,2.89,10.97,82.71,0.0,1.18
21111002402,Census Tract 24.02,2567,2473,87,19,2548,2461,310,2132,0,19,0.74,3.39,12.08,83.05,0.0,0.74
21111002700,Census Tract 27,2723,2588,109,92,2631,2522,387,2097,3,35,3.38,4.0,14.21,77.01,0.11,1.29
21111002800,Census Tract 28,1894,1813,65,54,1840,1775,310,1438,16,11,2.85,3.43,16.37,75.92,0.84,0.58
21111003000,Census Tract 30,1782,1735,39,95,1687,1648,454,1176,4,14,5.33,2.19,25.48,65.99,0.22,0.79
21111003501,Census Tract 35.01,3104,2921,145,132,2972,2827,2142,545,130,10,4.25,4.67,69.01,17.56,4.19,0.32
21111003502,Census Tract 35.02,1727,1646,69,33,1694,1625,211,1399,11,4,1.91,4.0,12.22,81.01,0.64,0.23
21111003600,Census Tract 36,4771,4427,271,309,4462,4191,1965,2152,41,33,6.48,5.68,41.19,45.11,0.86,0.69
21111003700,Census Tract 37,2187,1985,159,151,2036,1877,978,828,51,20,6.9,7.27,44.72,37.86,2.33,0.91
21111003800,Census Tract 38,3665,3391,201,450,3215,3014,2007,940,32,35,12.28,5.48,54.76,25.65,0.87,0.95
21111003900,Census Tract 39,3786,3505,189,419,3367,3178,1781,1328,29,40,11.07,4.99,47.04,35.08,0.77,1.06
21111004000,Census Tract 40,1737,1582,112,269,1468,1356,941,380,20,15,15.49,6.45,54.17,21.88,1.15,0.86
21111004100,Census Tract 41,2412,2225,124,266,2146,2022,1415,538,28,41,11.03,5.14,58.67,22.31,1.16,1.7
21111004301,Census Tract 43.01,4345,4080,201,180,4165,3964,926,2711,273,54,4.14,4.63,21.31,62.39,6.28,1.24
21111004302,Census Tract 43.02,1247,1129,82,115,1132,1050,560,477,11,2,9.22,6.58,44.91,38.25,0.88,0.16
21111004400,Census Tract 44,4368,3896,236,549,3819,3583,2752,638,147,46,12.57,5.4,63.0,14.61,3.37,1.05
21111004500,Census Tract 45,3329,3015,194,337,2992,2798,1730,895,150,23,10.12,5.83,51.97,26.88,4.51,0.69
21111004600,Census Tract 46,3840,3450,200,513,3327,3127,2140,539,408,40,13.36,5.21,55.73,14.04,10.62,1.04
21111004900,Census Tract 49,3941,3767,110,191,3750,3640,1809,1610,191,30,4.85,2.79,45.9,40.85,4.85,0.76
21111005000,Census Tract 50,1754,1650,75,86,1668,1593,645,865,49,34,4.9,4.28,36.77,49.32,2.79,1.94
21111005100,Census Tract 51,3107,2908,142,124,2983,2841,1599,1179,43,20,3.99,4.57,51.46,37.95,1.38,0.64
21111005200,Census Tract 52,3358,3058,229,169,3189,2960,2226,642,64,28,5.03,6.82,66.29,19.12,1.91,0.83
21111005300,Census Tract 53,3541,3360,159,198,3343,3184,2173,791,164,56,5.59,4.49,61.37,22.34,4.63,1.58
21111005600,Census Tract 56,3524,3225,153,416,3108,2955,1120,1358,446,31,11.8,4.34,31.78,38.54,12.66,0.88
21111005901,Census Tract 59.01,2361,2251,91,79,2282,2191,610,1478,88,15,3.35,3.85,25.84,62.6,3.73,0.64
21111005902,Census Tract 59.02,2875,2729,106,113,2762,2656,1518,912,163,63,3.93,3.69,52.8,31.72,5.67,2.19
21111006200,Census Tract 62,2422,2317,85,56,2366,2281,653,1582,15,31,2.31,3.51,26.96,65.32,0.62,1.28
21111006300,Census Tract 63,1663,1562,73,68,1595,1522,1405,82,13,22,4.09,4.39,84.49,4.93,0.78,1.32
21111006400,Census Tract 64,1801,1695,78,88,1713,1635,1485,76,59,15,4.89,4.33,82.45,4.22,3.28,0.83
21111006500,Census Tract 65,2763,2580,151,113,2650,2499,1214,1218,25,42,4.09,5.47,43.94,44.08,0.9,1.52
21111006600,Census Tract 66,1956,1821,101,84,1872,1771,1244,467,26,34,4.29,5.16,63.6,23.88,1.33,1.74
21111006800,Census Tract 68,2143,2008,97,86,2057,1960,1839,90,19,12,4.01,4.53,85.81,4.2,0.89,0.56
21111006900,Census Tract 69,2231,2122,77,72,2159,2082,1895,127,29,31,3.23,3.45,84.94,5.69,1.3,1.39
21111007000,Census Tract 70,2096,1983,80,48,2048,1968,1855,78,28,7,2.29,3.82,88.5,3.72,1.34,0.33
21111007101,Census Tract 71.01,149,135,12,5,144,132,115,15,1,1,3.36,8.05,77.18,10.07,0.67,0.67
21111007102,Census Tract 71.02,5182,4842,249,213,4969,4720,3587,742,367,24,4.11,4.81,69.22,14.32,7.08,0.46
21111007400,Census Tract 74,2436,2287,107,103,2333,2226,1990,172,52,12,4.23,4.39,81.69,7.06,2.13,0.49
21111007501,Census Tract 75.01,6750,6485,173,143,6607,6434,6239,53,123,19,2.12,2.56,92.43,0.79,1.82,0.28
21111007502,Census Tract 75.02,5602,5342,199,123,5479,5280,4739,275,221,45,2.2,3.55,84.59,4.91,3.95,0.8
21111007601,Census Tract 76.01,1939,1831,85,47,1892,1807,1611,128,49,19,2.42,4.38,83.08,6.6,2.53,0.98
21111007602,Census Tract 76.02,3739,3390,201,375,3364,3163,2267,779,83,34,10.03,5.38,60.63,20.83,2.22,0.91
21111007603,Census Tract 76.03,2530,2365,109,127,2403,2294,1730,458,93,13,5.02,4.31,68.38,18.1,3.68,0.51
21111007700,Census Tract 77,2335,2206,88,78,2257,2169,1885,213,62,9,3.34,3.77,80.73,9.12,2.66,0.39
21111007800,Census Tract 78,3157,3019,103,82,3075,2972,2864,51,43,14,2.6,3.26,90.72,1.62,1.36,0.44
21111007900,Census Tract 79,1788,1689,68,52,1736,1668,1576,48,34,10,2.91,3.8,88.14,2.68,1.9,0.56
21111008100,Census Tract 81,3684,3445,155,159,3525,3370,3045,197,93,35,4.32,4.21,82.65,5.35,2.52,0.95
21111008201,Census Tract 82.01,1823,1705,77,56,1767,1690,1597,69,20,4,3.07,4.22,87.6,3.78,1.1,0.22
21111008202,Census Tract 82.02,2061,1906,112,74,1987,1875,1736,82,51,6,3.59,5.43,84.23,3.98,2.47,0.29
21111008300,Census Tract 83,2482,2314,132,84,2398,2266,2129,90,29,18,3.38,5.32,85.78,3.63,1.17,0.73
21111008400,Census Tract 84,2891,2709,139,90,2801,2662,2503,103,46,10,3.11,4.81,86.58,3.56,1.59,0.35
21111008500,Census Tract 85,1927,1797,96,67,1860,1764,1649,51,39,25,3.48,4.98,85.57,2.65,2.02,1.3
21111008700,Census Tract 87,4188,4029,104,112,4076,3972,3622,113,221,16,2.67,2.48,86.49,2.7,5.28,0.38
21111008800,Census Tract 88,3809,3625,120,101,3708,3588,3440,97,40,11,2.65,3.15,90.31,2.55,1.05,0.29
21111008900,Census Tract 89,4691,4464,167,163,4528,4361,4081,141,81,58,3.47,3.56,87.0,3.01,1.73,1.24
21111009001,Census Tract 90.01,3700,3277,179,617,3083,2904,1616,769,474,45,16.68,4.84,43.68,20.78,12.81,1.22
21111009002,Census Tract 90.02,3571,3223,157,544,3027,2870,1955,721,172,22,15.23,4.4,54.75,20.19,4.82,0.62
21111009103,Census Tract 91.03,1646,1454,81,262,1384,1303,727,369,197,10,15.92,4.92,44.17,22.42,11.97,0.61
21111009105,Census Tract 91.05,2805,2432,68,937,1868,1800,1347,321,117,15,33.4,2.42,48.02,11.44,4.17,0.53
21111009106,Census Tract 91.06,5208,4677,178,859,4349,4171,2896,751,490,34,16.49,3.42,55.61,14.42,9.41,0.65
21111009300,Census Tract 93,4989,4741,206,97,4892,4686,4432,186,42,26,1.94,4.13,88.84,3.73,0.84,0.52
21111009401,Census Tract 94.01,3027,2824,153,123,2904,2751,2560,138,29,24,4.06,5.05,84.57,4.56,0.96,0.79
21111009402,Census Tract 94.02,3312,3128,139,101,3211,3072,2927,88,40,17,3.05,4.2,88.38,2.66,1.21,0.51
21111009600,Census Tract 96,4735,4477,164,148,4587,4423,4217,130,53,23,3.13,3.46,89.06,2.75,1.12,0.49
21111009700,Census Tract 97,2751,2603,110,114,2637,2527,2398,80,28,21,4.14,4.0,87.17,2.91,1.02,0.76
21111009800,Census Tract 98,2622,2494,99,54,2568,2469,2372,60,31,6,2.06,3.78,90.47,2.29,1.18,0.23
21111009900,Census Tract 99,2793,2656,89,102,2691,2602,2460,77,49,16,3.65,3.19,88.08,2.76,1.75,0.57
21111010001,Census Tract 100.01,4717,4526,110,115,4602,4492,4294,116,60,22,2.44,2.33,91.03,2.46,1.27,0.47
21111010004,Census Tract 100.04,4472,4092,221,418,4054,3833,2954,719,127,33,9.35,4.94,66.06,16.08,2.84,0.74
21111010005,Census Tract 100.05,4367,4060,207,313,4054,3847,3385,353,87,22,7.17,4.74,77.51,8.08,1.99,0.5
21111010006,Census Tract 100.06,3668,3455,147,187,3481,3334,2687,574,59,14,5.1,4.01,73.26,15.65,1.61,0.38
21111010007,Census Tract 100.07,4128,3872,118,177,3951,3833,3599,125,102,7,4.29,2.86,87.19,3.03,2.47,0.17
21111010008,Census Tract 100.08,4301,4010,214,211,4090,3876,3169,540,137,30,4.91,4.98,73.68,12.56,3.19,0.7
21111010102,Census Tract 101.02,4172,3957,157,111,4061,3904,3682,123,85,14,2.66,3.76,88.26,2.95,2.04,0.34
21111010103,Census Tract 101.03,3797,3489,190,284,3513,3323,2782,411,99,31,7.48,5.0,73.27,10.82,2.61,0.82
21111010104,Census Tract 101.04,2813,2558,129,242,2571,2442,2189,161,66,26,8.6,4.59,77.82,5.72,2.35,0.92
21111010309,Census Tract 103.09,4703,4478,124,148,4555,4431,3673,251,480,27,3.15,2.64,78.1,5.34,10.21,0.57
21111010312,Census Tract 103.12,3064,2914,94,98,2966,2872,2656,103,96,17,3.2,3.07,86.68,3.36,3.13,0.55
21111010313,Census Tract 103.13,6246,5877,249,213,6033,5784,5025,261,466,32,3.41,3.99,80.45,4.18,7.46,0.51
21111010314,Census Tract 103.14,6474,6049,267,253,6221,5954,4936,493,489,36,3.91,4.12,76.24,7.62,7.55,0.56
21111010315,Census Tract 103.15,3957,3725,149,191,3766,3617,2986,318,295,18,4.83,3.77,75.46,8.04,7.46,0.45
21111010316,Census Tract 103.16,4978,4755,164,138,4840,4676,4049,216,382,29,2.77,3.29,81.34,4.34,7.67,0.58
21111010317,Census Tract 103.17,4938,4741,143,127,4811,4668,4183,169,293,23,2.57,2.9,84.71,3.42,5.93,0.47
21111010318,Census Tract 103.18,5654,5370,214,156,5498,5284,4691,263,312,18,2.76,3.78,82.97,4.65,5.52,0.32
21111010319,Census Tract 103.19,4453,4120,216,338,4115,3899,2833,738,300,28,7.59,4.85,63.62,16.57,6.74,0.63
21111010320,Census Tract 103.20,3855,3499,248,334,3521,3273,1910,1052,263,48,8.66,6.43,49.55,27.29,6.82,1.25
21111010321,Census Tract 103.21,5965,5532,273,263,5702,5429,4348,452,602,27,4.41,4.58,72.89,7.58,10.09,0.45
21111010322,Census Tract 103.22,3167,2981,127,92,3075,2948,2437,271,231,9,2.9,4.01,76.95,8.56,7.29,0.28
21111010323,Census Tract 103.23,3022,2788,162,143,2879,2717,2001,334,361,21,4.73,5.36,66.21,11.05,11.95,0.69
21111010324,Census Tract 103.24,5141,4668,302,404,4737,4435,2774,1294,335,32,7.86,5.87,53.96,25.17,6.52,0.62
21111010403,Census Tract 104.03,4532,4262,176,193,4339,4163,3606,291,245,21,4.26,3.88,79.57,6.42,5.41,0.46
21111010405,Census Tract 104.05,4467,4167,160,314,4153,3993,3091,574,291,37,7.03,3.58,69.2,12.85,6.51,0.83
21111010406,Census Tract 104.06,6226,5802,279,270,5956,5677,4784,646,224,23,4.34,4.48,76.84,10.38,3.6,0.37
21111010407,Census Tract 104.07,4473,4186,178,212,4261,4083,3412,396,244,31,4.74,3.98,76.28,8.85,5.45,0.69
21111010408,Census Tract 104.08,3486,3208,179,184,3302,3123,2773,212,113,25,5.28,5.13,79.55,6.08,3.24,0.72
21111010500,Census Tract 105,3893,3678,143,154,3739,3596,3328,149,91,28,3.96,3.67,85.49,3.83,2.34,0.72
21111010601,Census Tract 106.01,2976,2819,110,100,2876,2766,2561,146,48,11,3.36,3.7,86.06,4.91,1.61,0.37
21111010602,Census Tract 106.02,3366,3102,139,371,2995,2856,2221,460,166,9,11.02,4.13,65.98,13.67,4.93,0.27
21111010701,Census Tract 107.01,5282,5064,136,161,5121,4985,3790,264,884,47,3.05,2.57,71.75,5.0,16.74,0.89
21111010702,Census Tract 107.02,6097,5726,215,370,5727,5512,3955,578,951,28,6.07,3.53,64.87,9.48,15.6,0.46
21111010706,Census Tract 107.06,3090,2962,100,106,2984,2884,2725,101,45,13,3.43,3.24,88.19,3.27,1.46,0.42
21111010707,Census Tract 107.07,3688,3512,121,145,3543,3422,2558,240,544,80,3.93,3.28,69.36,6.51,14.75,2.17
21111010708,Census Tract 107.08,2692,2508,117,149,2543,2426,1812,265,312,37,5.53,4.35,67.31,9.84,11.59,1.37
21111010800,Census Tract 108,3847,3661,128,158,3689,3561,3082,370,82,27,4.11,3.33,80.11,9.62,2.13,0.7
21111010901,Census Tract 109.01,5021,4532,212,578,4443,4231,2888,1078,230,35,11.51,4.22,57.52,21.47,4.58,0.7
21111010902,Census Tract 109.02,4069,3741,210,270,3799,3589,3078,357,126,28,6.64,5.16,75.65,8.77,3.1,0.69
21111011003,Census Tract 110.03,6449,6022,252,540,5909,5657,3720,1117,762,58,8.37,3.91,57.68,17.32,11.82,0.9
21111011005,Census Tract 110.05,2820,2591,139,315,2505,2366,1638,634,66,28,11.17,4.93,58.09,22.48,2.34,0.99
21111011006,Census Tract 110.06,2518,2284,107,266,2252,2145,921,886,315,23,10.56,4.25,36.58,35.19,12.51,0.91
21111011007,Census Tract 110.07,3639,3307,180,488,3151,2971,952,1492,506,21,13.41,4.95,26.16,41.0,13.9,0.58
21111011008,Census Tract 110.08,3182,2829,139,539,2643,2504,1584,758,130,32,16.94,4.37,49.78,23.82,4.09,1.01
21111011009,Census Tract 110.09,3279,3120,108,149,3130,3022,2392,473,134,23,4.54,3.29,72.95,14.43,4.09,0.7
21111011109,Census Tract 111.09,2252,2087,106,135,2117,2011,1600,340,54,17,5.99,4.71,71.05,15.1,2.4,0.75
21111011110,Census Tract 111.10,6570,6112,310,400,6170,5860,5034,674,107,45,6.09,4.72,76.62,10.26,1.63,0.68
21111011111,Census Tract 111.11,5328,5018,220,217,5111,4891,3791,797,259,44,4.07,4.13,71.15,14.96,4.86,0.83
21111011112,Census Tract 111.12,3477,3243,128,213,3264,3136,2288,730,94,24,6.13,3.68,65.8,21.0,2.7,0.69
21111011113,Census Tract 111.13,3013,2848,116,110,2903,2787,2131,477,154,25,3.65,3.85,70.73,15.83,5.11,0.83
21111011114,Census Tract 111.14,5341,5035,198,260,5081,4883,3205,1385,259,34,4.87,3.71,60.01,25.93,4.85,0.64
21111011115,Census Tract 111.15,2823,2622,131,172,2651,2520,2290,190,26,14,6.09,4.64,81.12,6.73,0.92,0.5
21111011116,Census Tract 111.16,3724,3465,159,257,3467,3308,2848,334,116,10,6.9,4.27,76.48,8.97,3.11,0.27
21111011117,Census Tract 111.17,3491,3018,212,613,2878,2666,2053,524,85,4,17.56,6.07,58.81,15.01,2.43,0.11
21111011118,Census Tract 111.18,3893,3599,186,348,3545,3359,3005,289,49,16,8.94,4.78,77.19,7.42,1.26,0.41
21111011201,Census Tract 112.01,1515,1367,91,130,1385,1294,682,527,69,16,8.58,6.01,45.02,34.79,4.55,1.06
21111011202,Census Tract 112.02,4193,3640,180,769,3424,3244,1346,1621,242,35,18.34,4.29,32.1,38.66,5.77,0.83
21111011301,Census Tract 113.01,2425,2198,104,484,1941,1837,564,1226,24,23,19.96,4.29,23.26,50.56,0.99,0.95
21111011302,Census Tract 113.02,7086,6346,308,1337,5749,5441,784,4509,89,59,18.87,4.35,11.06,63.63,1.26,0.83
21111011403,Census Tract 114.03,1944,1790,91,200,1744,1653,1468,155,10,20,10.29,4.68,75.51,7.97,0.51,1.03
21111011404,Census Tract 114.04,3967,3201,119,1789,2178,2059,1004,977,51,27,45.1,3.0,25.31,24.63,1.29,0.68
21111011405,Census Tract 114.05,5945,5055,245,1493,4452,4207,1297,2693,160,57,25.11,4.12,21.82,45.3,2.69,0.96
21111011406,Census Tract 114.06,5241,4602,215,1163,4078,3863,1929,1804,81,49,22.19,4.1,36.81,34.42,1.55,0.93
21111011506,Census Tract 115.06,5689,5171,298,590,5099,4801,3850,815,104,32,10.37,5.24,67.67,14.33,1.83,0.56
21111011508,Census Tract 115.08,6773,6252,323,482,6291,5968,3468,1676,774,50,7.12,4.77,51.2,24.75,11.43,0.74
21111011509,Census Tract 115.09,4204,3785,222,539,3665,3443,2349,986,77,31,12.82,5.28,55.88,23.45,1.83,0.74
21111011513,Census Tract 115.13,4434,3952,218,487,3947,3729,2944,670,84,31,10.98,4.92,66.4,15.11,1.89,0.7
21111011514,Census Tract 115.14,3720,3426,177,217,3503,3326,2559,606,152,9,5.83,4.76,68.79,16.29,4.09,0.24
21111011515,Census Tract 115.15,4849,4516,249,252,4597,4348,3687,547,74,40,5.2,5.14,76.04,11.28,1.53,0.82
21111011516,Census Tract 115.16,4064,3772,176,268,3796,3620,2955,585,69,11,6.59,4.33,72.71,14.39,1.7,0.27
21111011517,Census Tract 115.17,5560,5105,290,307,5253,4963,4065,716,143,39,5.52,5.22,73.11,12.88,2.57,0.7
21111011518,Census Tract 115.18,2292,2172,94,70,2222,2128,1925,143,55,5,3.05,4.1,83.99,6.24,2.4,0.22
21111011519,Census Tract 115.19,6168,5688,332,355,5813,5481,4499,762,174,46,5.76,5.38,72.94,12.35,2.82,0.75
21111011520,Census Tract 115.20,5543,5259,208,233,5310,5102,4305,672,103,22,4.2,3.75,77.67,12.12,1.86,0.4
21111011521,Census Tract 115.21,4349,3625,184,1026,3323,3139,1984,868,245,42,23.59,4.23,45.62,19.96,5.63,0.97
21111011522,Census Tract 115.22,2747,2553,101,174,2573,2472,1711,587,165,9,6.33,3.68,62.29,21.37,6.01,0.33
21111011603,Census Tract 116.03,5257,4973,219,124,5133,4914,4266,480,127,41,2.36,4.17,81.15,9.13,2.42,0.78
21111011604,Census Tract 116.04,2639,2514,93,69,2570,2477,2403,36,17,21,2.61,3.52,91.06,1.36,0.64,0.8
21111011605,Census Tract 116.05,7534,7079,289,304,7230,6941,5897,576,442,26,4.04,3.84,78.27,7.65,5.87,0.35
21111011606,Census Tract 116.06,1797,1702,61,55,1742,1681,1584,69,24,4,3.06,3.39,88.15,3.84,1.34,0.22
21111011706,Census Tract 117.06,3930,3592,153,394,3536,3383,3055,259,51,18,10.03,3.89,77.74,6.59,1.3,0.46
21111011707,Census Tract 117.07,6383,5778,339,531,5852,5513,4070,1228,179,36,8.32,5.31,63.76,19.24,2.8,0.56
21111011708,Census Tract 117.08,6239,5756,248,785,5454,5206,4225,794,159,28,12.58,3.97,67.72,12.73,2.55,0.45
21111011709,Census Tract 117.09,6475,6122,259,268,6207,5948,5014,654,216,64,4.14,4.0,77.44,10.1,3.34,0.99
21111011710,Census Tract 117.10,2891,2584,177,307,2584,2407,2020,326,42,19,10.62,6.12,69.87,11.28,1.45,0.66
21111011711,Census Tract 117.11,6490,5996,301,472,6018,5717,4585,903,181,48,7.27,4.64,70.65,13.91,2.79,0.74
21111011712,Census Tract 117.12,4795,4304,246,490,4305,4059,3359,531,138,31,10.22,5.13,70.05,11.07,2.88,0.65
21111011713,Census Tract 117.13,2744,2415,164,364,2380,2216,1779,398,30,9,13.27,5.98,64.83,14.5,1.09,0.33
21111011800,Census Tract 118,2348,2113,98,408,1940,1842,1300,482,23,37,17.38,4.17,55.37,20.53,0.98,1.58
21111011901,Census Tract 119.01,1154,1004,10,910,244,234,196,17,10,11,78.86,0.87,16.98,1.47,0.87,0.95
21111011904,Census Tract 119.04,2653,2224,128,769,1884,1756,1329,373,35,19,28.99,4.82,50.09,14.06,1.32,0.72
21111011906,Census Tract 119.06,3992,3380,170,1276,2716,2546,1631,835,64,16,31.96,4.26,40.86,20.92,1.6,0.4
21111011907,Census Tract 119.07,4505,4101,179,542,3963,3784,3114,433,211,26,12.03,3.97,69.12,9.61,4.68,0.58
21111011908,Census Tract 119.08,3670,3101,213,817,2853,2640,1587,962,53,38,22.26,5.8,43.24,26.21,1.44,1.04
21111011909,Census Tract 119.09,4119,3657,186,673,3446,3260,2694,444,80,42,16.34,4.52,65.4,10.78,1.94,1.02
21111012001,Census Tract 120.01,3378,3191,135,245,3133,2998,2867,64,32,35,7.25,4.0,84.87,1.89,0.95,1.04
21111012003,Census Tract 120.03,3726,3456,143,572,3154,3011,2846,129,13,23,15.35,3.84,76.38,3.46,0.35,0.62
21111012004,Census Tract 120.04,2417,2074,87,1046,1371,1284,1220,42,6,16,43.28,3.6,50.48,1.74,0.25,0.66
21111012005,Census Tract 120.05,3676,3387,184,349,3327,3143,2656,414,59,14,9.49,5.01,72.25,11.26,1.61,0.38
21111012103,Census Tract 121.03,3815,3551,192,179,3636,3444,2987,406,18,33,4.69,5.03,78.3,10.64,0.47,0.87
21111012104,Census Tract 121.04,4072,3800,189,258,3814,3625,3157,408,17,43,6.34,4.64,77.53,10.02,0.42,1.06
21111012105,Census Tract 121.05,5093,4727,277,230,4863,4586,3790,691,66,39,4.52,5.44,74.42,13.57,1.3,0.77
21111012107,Census Tract 121.07,5271,4829,350,309,4962,4612,4313,253,23,23,5.86,6.64,81.83,4.8,0.44,0.44
21111012108,Census Tract 121.08,2106,1938,134,115,1991,1857,1530,263,35,29,5.46,6.36,72.65,12.49,1.66,1.38
21111012109,Census Tract 121.09,5723,5248,315,304,5419,5104,4369,667,48,20,5.31,5.5,76.34,11.65,0.84,0.35
21111012203,Census Tract 122.03,6316,5896,277,272,6044,5767,4839,686,107,135,4.31,4.39,76.61,10.86,1.69,2.14
21111012204,Census Tract 122.04,4707,4347,232,367,4340,4108,2842,1059,163,44,7.8,4.93,60.38,22.5,3.46,0.93
21111012205,Census Tract 122.05,2053,1883,106,181,1872,1766,1133,493,121,19,8.82,5.16,55.19,24.01,5.89,0.93
21111012206,Census Tract 122.06,4919,4481,185,570,4349,4164,2772,993,339,60,11.59,3.76,56.35,20.19,6.89,1.22
21111012301,Census Tract 123.01,3716,3306,107,520,3196,3089,1829,813,428,19,13.99,2.88,49.22,21.88,11.52,0.51
21111012302,Census Tract 123.02,5380,4971,288,374,5006,4718,3234,1312,142,30,6.95,5.35,60.11,24.39,2.64,0.56
21111012406,Census Tract 124.06,6034,5564,299,349,5685,5386,4370,937,33,46,5.78,4.96,72.42,15.53,0.55,0.76
21111012407,Census Tract 124.07,4992,4644,257,243,4749,4492,3384,1047,33,28,4.87,5.15,67.79,20.97,0.66,0.56
21111012408,Census Tract 124.08,2316,2119,100,178,2138,2038,1718,297,5,18,7.69,4.32,74.18,12.82,0.22,0.78
21111012409,Census Tract 124.09,3268,2997,216,158,3110,2894,2623,248,8,15,4.83,6.61,80.26,7.59,0.24,0.46
21111012410,Census Tract 124.10,4194,3977,106,213,3981,3875,2914,892,51,18,5.08,2.53,69.48,21.27,1.22,0.43
21111012412,Census Tract 124.12,3247,3008,154,140,3107,2953,2295,598,46,14,4.31,4.74,70.68,18.42,1.42,0.43
21111012413,Census Tract 124.13,3176,2926,170,169,3007,2837,2173,576,52,36,5.32,5.35,68.42,18.14,1.64,1.13
21111012501,Census Tract 125.01,2588,2368,142,236,2352,2210,1250,929,14,17,9.12,5.49,48.3,35.9,0.54,0.66
21111012502,Census Tract 125.02,5224,4843,226,371,4853,4627,3323,1209,55,40,7.1,4.33,63.61,23.14,1.05,0.77
21111012503,Census Tract 125.03,4157,3835,191,315,3842,3651,2451,1133,34,33,7.58,4.59,58.96,27.26,0.82,0.79
21111012603,Census Tract 126.03,2899,2716,108,185,2714,2606,1105,1480,11,10,6.38,3.73,38.12,51.05,0.38,0.34
21111012604,Census Tract 126.04,5560,5162,247,367,5193,4946,2184,2674,51,37,6.6,4.44,39.28,48.09,0.92,0.67
21111012605,Census Tract 126.05,3277,3089,124,181,3096,2972,781,2142,19,30,5.52,3.78,23.83,65.36,0.58,0.92
21111012606,Census Tract 126.06,3818,3593,119,228,3590,3471,921,2483,42,25,5.97,3.12,24.12,65.03,1.1,0.65
21111012701,Census Tract 127.01,4284,4033,173,279,4005,3832,1075,2708,9,40,6.51,4.04,25.09,63.21,0.21,0.93
21111012702,Census Tract 127.02,1936,1786,107,122,1814,1707,1304,377,0,26,6.3,5.53,67.36,19.47,0.0,1.34
21111012703,Census Tract 127.03,5855,5439,314,356,5499,5185,3979,1129,42,35,6.08,5.36,67.96,19.28,0.72,0.6
21111012801,Census Tract 128.01,3185,3004,142,79,3106,2964,377,2554,11,22,2.48,4.46,11.84,80.19,0.35,0.69
21111012802,Census Tract 128.02,2646,2452,130,261,2385,2255,575,1631,19,30,9.86,4.91,21.73,61.64,0.72,1.13
21111013100,Census Tract 131,1183,1115,45,37,1146,1101,1060,11,15,15,3.13,3.8,89.6,0.93,1.27,1.27
21111980100,Census Tract 9801,14,8,5,1,13,8,7,1,0,0,7.14,35.71,50.0,7.14,0.0,0.0
21113060102,Census Tract 601.02,7214,6733,353,312,6902,6549,6022,402,72,53,4.32,4.89,83.48,5.57,1.0,0.73
21113060103,Census Tract 601.03,3094,2878,185,168,2926,2741,2419,290,13,19,5.43,5.98,78.18,9.37,0.42,0.61
21113060104,Census Tract 601.04,4976,4719,163,236,4740,4577,4293,197,53,34,4.74,3.28,86.27,3.96,1.07,0.68
21113060200,Census Tract 602,5183,4868,189,415,4768,4579,4428,77,49,25,8.01,3.65,85.43,1.49,0.95,0.48
21113060300,Census Tract 603,2492,2417,54,46,2446,2392,2338,25,14,15,1.85,2.17,93.82,1.0,0.56,0.6
21113060401,Census Tract 604.01,4061,3866,146,160,3901,3755,3488,119,125,23,3.94,3.6,85.89,2.93,3.08,0.57
21113060402,Census Tract 604.02,4495,4328,133,143,4352,4219,4031,80,79,29,3.18,2.96,89.68,1.78,1.76,0.65
21113060502,Census Tract 605.02,7094,6600,343,351,6743,6400,5834,503,27,36,4.95,4.84,82.24,7.09,0.38,0.51
21113060503,Census Tract 605.03,4520,4247,229,179,4341,4112,3880,183,30,19,3.96,5.07,85.84,4.05,0.66,0.42
21113060504,Census Tract 605.04,3230,2981,186,196,3034,2848,2546,266,11,25,6.07,5.76,78.82,8.24,0.34,0.77
21113060600,Census Tract 606,6632,6339,224,178,6454,6230,5912,105,185,28,2.68,3.38,89.14,1.58,2.79,0.42
21115960100,Census Tract 9601,3227,3168,56,20,3207,3151,3140,1,1,9,0.62,1.74,97.3,0.03,0.03,0.28
21115960200,Census Tract 9602,2751,2702,40,24,2727,2687,2680,4,0,3,0.87,1.45,97.42,0.15,0.0,0.11
21115960300,Census Tract 9603,3325,3252,60,23,3302,3242,3232,7,0,3,0.69,1.8,97.2,0.21,0.0,0.09
21115960401,Census Tract 9604.01,3605,3525,68,50,3555,3487,3414,22,46,5,1.39,1.89,94.7,0.61,1.28,0.14
21115960402,Census Tract 9604.02,2692,2613,62,30,2662,2600,2570,0,25,5,1.11,2.3,95.47,0.0,0.93,0.19
21115960500,Census Tract 9605,2675,2606,53,27,2648,2595,2577,3,5,10,1.01,1.98,96.34,0.11,0.19,0.37
21115960600,Census Tract 9606,4405,4311,81,24,4381,4300,4247,5,24,24,0.54,1.84,96.41,0.11,0.54,0.54
21117060300,Census Tract 603,1529,1440,59,85,1444,1385,1265,99,8,13,5.56,3.86,82.73,6.47,0.52,0.85
21117060700,Census Tract 607,1430,1315,83,137,1293,1210,983,202,11,14,9.58,5.8,68.74,14.13,0.77,0.98
21117060900,Census Tract 609,2356,2162,128,432,1924,1796,1408,356,9,23,18.34,5.43,59.76,15.11,0.38,0.98
21117061000,Census Tract 610,2117,1915,171,117,2000,1829,1466,338,8,17,5.53,8.08,69.25,15.97,0.38,0.8
21117061100,Census Tract 611,1422,1347,64,47,1375,1311,1174,119,7,11,3.31,4.5,82.56,8.37,0.49,0.77
21117061200,Census Tract 612,2562,2395,141,65,2497,2356,2233,93,9,21,2.54,5.5,87.16,3.63,0.35,0.82
21117061300,Census Tract 613,2447,2263,145,77,2370,2225,2100,90,17,18,3.15,5.93,85.82,3.68,0.69,0.74
21117061400,Census Tract 614,3502,3253,208,131,3371,3163,2973,148,9,33,3.74,5.94,84.89,4.23,0.26,0.94
21117061600,Census Tract 616,1343,1215,88,235,1108,1020,880,112,15,13,17.5,6.55,65.52,8.34,1.12,0.97
21117063604,Census Tract 636.04,6741,6219,378,333,6408,6030,5744,186,75,25,4.94,5.61,85.21,2.76,1.11,0.37
21117063606,Census Tract 636.06,4375,4134,180,106,4269,4089,3992,58,26,13,2.42,4.11,91.25,1.33,0.59,0.3
21117063607,Census Tract 636.07,2747,2522,124,444,2303,2179,2048,63,53,15,16.16,4.51,74.55,2.29,1.93,0.55
21117063608,Census Tract 636.08,6785,6400,305,249,6536,6231,5877,205,123,26,3.67,4.5,86.62,3.02,1.81,0.38
21117063609,Census Tract 636.09,5827,5543,226,133,5694,5468,5308,88,51,21,2.28,3.88,91.09,1.51,0.88,0.36
21117063610,Census Tract 636.10,6769,6402,319,164,6605,6286,6086,100,59,41,2.42,4.71,89.91,1.48,0.87,0.61
21117063701,Census Tract 637.01,3589,3471,101,57,3532,3431,3386,27,11,7,1.59,2.81,94.34,0.75,0.31,0.2
21117063702,Census Tract 637.02,4595,4417,165,44,4551,4386,4367,10,9,0,0.96,3.59,95.04,0.22,0.2,0.0
21117063800,Census Tract 638,3011,2834,139,96,2915,2776,2615,108,38,15,3.19,4.62,86.85,3.59,1.26,0.5
21117064001,Census Tract 640.01,3268,3139,88,71,3197,3109,3037,19,38,15,2.17,2.69,92.93,0.58,1.16,0.46
21117064002,Census Tract 640.02,3298,3134,126,98,3200,3074,2861,83,106,24,2.97,3.82,86.75,2.52,3.21,0.73
21117064300,Census Tract 643,3452,3183,196,140,3312,3116,2886,135,63,32,4.06,5.68,83.6,3.91,1.83,0.93
21117064400,Census Tract 644,4083,3699,276,327,3756,3480,3060,275,56,89,8.01,6.76,74.94,6.74,1.37,2.18
21117064500,Census Tract 645,3595,3430,129,69,3526,3397,3282,66,33,16,1.92,3.59,91.29,1.84,0.92,0.45
21117064600,Census Tract 646,5376,5161,155,193,5183,5028,4697,253,50,28,3.59,2.88,87.37,4.71,0.93,0.52
21117064700,Census Tract 647,5646,5372,231,120,5526,5295,5003,163,105,24,2.13,4.09,88.61,2.89,1.86,0.43
21117064800,Census Tract 648,3694,3470,122,253,3441,3319,3153,96,62,8,6.85,3.3,85.35,2.6,1.68,0.22
21117064900,Census Tract 649,3186,3008,113,220,2966,2853,2661,135,38,19,6.91,3.55,83.52,4.24,1.19,0.6
21117065000,Census Tract 650,3690,3356,243,466,3224,2981,2452,482,18,29,12.63,6.59,66.45,13.06,0.49,0.79
21117065100,Census Tract 651,3390,3054,278,129,3261,2983,1873,1062,17,31,3.81,8.2,55.25,31.33,0.5,0.91
21117065200,Census Tract 652,3986,3782,151,125,3861,3710,3531,131,27,21,3.14,3.79,88.59,3.29,0.68,0.53
21117065300,Census Tract 653,10232,9661,465,272,9960,9495,9095,222,114,64,2.66,4.54,88.89,2.17,1.11,0.63
21117065400,Census Tract 654,1562,1475,67,62,1500,1433,1259,130,33,11,3.97,4.29,80.6,8.32,2.11,0.7
21117065501,Census Tract 655.01,4314,4129,151,83,4231,4080,3978,50,40,12,1.92,3.5,92.21,1.16,0.93,0.28
21117065502,Census Tract 655.02,3930,3743,132,93,3837,3705,3633,12,54,6,2.37,3.36,92.44,0.31,1.37,0.15
21117065600,Census Tract 656,6360,5784,447,487,5873,5426,4833,496,35,62,7.66,7.03,75.99,7.8,0.55,0.97
21117065700,Census Tract 657,2101,1932,130,153,1948,1818,1719,70,8,21,7.28,6.19,81.82,3.33,0.38,1.0
21117065800,Census Tract 658,3492,3316,148,61,3431,3283,3199,54,18,12,1.75,4.24,91.61,1.55,0.52,0.34
21117065900,Census Tract 659,1438,1376,57,22,1416,1359,1352,0,3,4,1.53,3.96,94.02,0.0,0.21,0.28
21117066801,Census Tract 668.01,3881,3605,240,96,3785,3545,3420,81,27,17,2.47,6.18,88.12,2.09,0.7,0.44
21117066802,Census Tract 668.02,4884,4612,197,138,4746,4549,4356,115,65,13,2.83,4.03,89.19,2.35,1.33,0.27
21117066900,Census Tract 669,4069,3822,211,88,3981,3770,3669,78,13,10,2.16,5.19,90.17,1.92,0.32,0.25
21117067000,Census Tract 670,3392,3174,148,234,3158,3010,2576,352,48,34,6.9,4.36,75.94,10.38,1.42,1.0
21117067100,Census Tract 671,2341,2100,164,428,1913,1749,821,896,5,27,18.28,7.01,35.07,38.27,0.21,1.15
21117067200,Census Tract 672,7257,6802,367,361,6896,6529,5856,203,401,69,4.97,5.06,80.69,2.8,5.53,0.95
21119960100,Census Tract 9601,2023,1982,39,13,2010,1971,1969,0,2,0,0.64,1.93,97.33,0.0,0.1,0.0
21119960200,Census Tract 9602,2663,2591,70,5,2658,2588,2580,2,1,5,0.19,2.63,96.88,0.08,0.04,0.19
21119960300,Census Tract 9603,3627,3561,64,37,3590,3526,3508,7,6,5,1.02,1.76,96.72,0.19,0.17,0.14
21119960400,Census Tract 9604,2014,1993,19,3,2011,1992,1989,1,2,0,0.15,0.94,98.76,0.05,0.1,0.0
21119960500,Census Tract 9605,3924,3850,58,32,3892,3834,3767,55,7,5,0.82,1.48,96.0,1.4,0.18,0.13
21121930100,Census Tract 9301,1349,1320,27,12,1337,1310,1304,3,0,3,0.89,2.0,96.66,0.22,0.0,0.22
21121930200,Census Tract 9302,3452,3349,95,24,3428,3333,3313,8,2,10,0.7,2.75,95.97,0.23,0.06,0.29
21121930300,Census Tract 9303,2976,2835,131,31,2945,2814,2790,4,5,15,1.04,4.4,93.75,0.13,0.17,0.5
21121930401,Census Tract 9304.01,4417,4258,131,77,4340,4209,4159,17,17,16,1.74,2.97,94.16,0.38,0.38,0.36
21121930402,Census Tract 9304.02,3159,3054,87,41,3118,3031,3000,3,24,4,1.3,2.75,94.97,0.09,0.76,0.13
21121930501,Census Tract 9305.01,2112,2045,53,21,2091,2038,2025,3,3,7,0.99,2.51,95.88,0.14,0.14,0.33
21121930502,Census Tract 9305.02,3827,3712,100,51,3776,3676,3515,127,15,19,1.33,2.61,91.85,3.32,0.39,0.5
21121930602,Census Tract 9306.02,1719,1640,62,32,1687,1625,1541,70,3,11,1.86,3.61,89.65,4.07,0.17,0.64
21121930603,Census Tract 9306.03,2872,2771,79,43,2829,2750,2690,25,16,19,1.5,2.75,93.66,0.87,0.56,0.66
21121930604,Census Tract 9306.04,2492,2454,34,7,2485,2451,2426,18,0,7,0.28,1.36,97.35,0.72,0.0,0.28
21121930700,Census Tract 9307,1818,1756,55,8,1810,1755,1746,3,0,6,0.44,3.03,96.04,0.17,0.0,0.33
21123960101,Census Tract 9601.01,1684,1606,64,20,1664,1600,1581,13,4,2,1.19,3.8,93.88,0.77,0.24,0.12
21123960103,Census Tract 9601.03,3726,3528,163,145,3581,3418,3223,156,15,24,3.89,4.37,86.5,4.19,0.4,0.64
21123960104,Census Tract 9601.04,2686,2557,98,129,2557,2459,2302,126,5,26,4.8,3.65,85.7,4.69,0.19,0.97
21123960200,Census Tract 9602,2755,2606,128,75,2680,2552,2500,27,1,24,2.72,4.65,90.74,0.98,0.04,0.87
21123960300,Census Tract 9603,4016,3877,121,110,3906,3785,3693,55,4,33,2.74,3.01,91.96,1.37,0.1,0.82
21125970100,Census Tract 9701,3285,3189,90,31,3254,3164,3137,7,9,11,0.94,2.74,95.49,0.21,0.27,0.33
21125970201,Census Tract 9702.01,4169,4055,103,57,4112,4009,3948,41,10,10,1.37,2.47,94.7,0.98,0.24,0.24
21125970202,Census Tract 9702.02,2696,2601,84,19,2677,2593,2552,25,3,13,0.7,3.12,94.66,0.93,0.11,0.48
21125970300,Census Tract 9703,4474,4263,197,44,4430,4233,4188,8,22,15,0.98,4.4,93.61,0.18,0.49,0.34
21125970400,Census Tract 9704,3819,3674,134,65,3754,3620,3482,33,92,13,1.7,3.51,91.18,0.86,2.41,0.34
21125970500,Census Tract 9705,4588,4376,183,155,4433,4250,4134,54,46,16,3.38,3.99,90.1,1.18,1.0,0.35
21125970600,Census Tract 9706,3002,2885,100,52,2950,2850,2742,69,31,8,1.73,3.33,91.34,2.3,1.03,0.27
21125970700,Census Tract 9707,5862,5643,193,150,5712,5519,5417,57,29,16,2.56,3.29,92.41,0.97,0.49,0.27
21125970800,Census Tract 9708,5427,5254,142,88,5339,5197,5086,26,64,21,1.62,2.62,93.72,0.48,1.18,0.39
21125970900,Census Tract 9709,4141,3991,132,35,4106,3974,3943,15,9,7,0.85,3.19,95.22,0.36,0.22,0.17
21125971001,Census Tract 9710.01,4118,4013,94,46,4072,3978,3918,30,13,17,1.12,2.28,95.14,0.73,0.32,0.41
21125971003,Census Tract 9710.03,3823,3637,151,87,3736,3585,3488,29,49,19,2.28,3.95,91.24,0.76,1.28,0.5
21125971004,Census Tract 9710.04,2788,2712,63,31,2757,2694,2639,9,19,27,1.11,2.26,94.66,0.32,0.68,0.97
21125971101,Census Tract 9711.01,2583,2501,71,30,2553,2482,2461,5,5,11,1.16,2.75,95.28,0.19,0.19,0.43
21125971103,Census Tract 9711.03,4544,4379,142,65,4479,4337,4291,18,9,19,1.43,3.12,94.43,0.4,0.2,0.42
21125971104,Census Tract 9711.04,3294,3174,110,56,3238,3128,3077,14,16,21,1.7,3.34,93.41,0.43,0.49,0.64
21127930101,Census Tract 9301.01,2857,2794,56,24,2833,2777,2768,1,2,6,0.84,1.96,96.88,0.04,0.07,0.21
21127930102,Census Tract 9301.02,4658,4539,100,49,4609,4509,4460,23,13,13,1.05,2.15,95.75,0.49,0.28,0.28
21127930200,Census Tract 9302,1726,1662,50,18,1708,1658,1652,1,2,3,1.04,2.9,95.71,0.06,0.12,0.17
21127930300,Census Tract 9303,1511,1483,27,9,1502,1475,1466,5,1,3,0.6,1.79,97.02,0.33,0.07,0.2
21127930400,Census Tract 9304,2979,2915,60,11,2968,2908,2902,3,2,1,0.37,2.01,97.42,0.1,0.07,0.03
21127930500,Census Tract 9305,2562,2505,41,37,2525,2484,2473,3,3,5,1.44,1.6,96.53,0.12,0.12,0.2
21129950100,Census Tract 9501,4569,4480,77,39,4530,4453,4179,269,0,5,0.85,1.69,91.46,5.89,0.0,0.11
21129950200,Census Tract 9502,1440,1400,32,16,1424,1392,1378,4,0,10,1.11,2.22,95.69,0.28,0.0,0.69
21129950300,Census Tract 9503,1386,1346,39,5,1381,1342,1330,7,0,5,0.36,2.81,95.96,0.51,0.0,0.36
21131920101,Census Tract 9201.01,2881,2835,41,21,2860,2819,2789,17,7,6,0.73,1.42,96.81,0.59,0.24,0.21
21131920102,Census Tract 9201.02,2439,2374,58,15,2424,2366,2346,13,1,6,0.62,2.38,96.19,0.53,0.04,0.25
21131920200,Census Tract 9202,2490,2424,64,8,2482,2418,2406,5,4,3,0.32,2.57,96.63,0.2,0.16,0.12
21131920300,Census Tract 9203,2703,2658,35,28,2675,2640,2629,4,3,4,1.04,1.29,97.26,0.15,0.11,0.15
21133950100,Census Tract 9501,2588,2526,48,37,2551,2503,2478,12,6,7,1.43,1.85,95.75,0.46,0.23,0.27
21133950201,Census Tract 9502.01,2212,2157,49,7,2205,2156,2139,10,2,5,0.32,2.22,96.7,0.45,0.09,0.23
21133950202,Census Tract 9502.02,2283,2204,75,11,2272,2197,2169,23,2,3,0.48,3.29,95.01,1.01,0.09,0.13
21133950300,Census Tract 9503,1241,1223,18,2,1239,1221,1219,2,0,0,0.16,1.45,98.23,0.16,0.0,0.0
21133950401,Census Tract 9504.01,2679,2616,56,21,2658,2602,2562,17,13,10,0.78,2.09,95.63,0.63,0.49,0.37
21133950403,Census Tract 9504.03,2180,2143,33,14,2166,2133,2122,4,3,4,0.64,1.51,97.34,0.18,0.14,0.18
21133950404,Census Tract 9504.04,2284,2251,27,20,2264,2237,2196,12,26,3,0.88,1.18,96.15,0.53,1.14,0.13
21133950500,Census Tract 9505,1219,1179,38,9,1210,1172,1165,1,2,4,0.74,3.12,95.57,0.08,0.16,0.33
21133950601,Census Tract 9506.01,2198,2147,49,8,2190,2141,2126,5,1,9,0.36,2.23,96.72,0.23,0.05,0.41
21133950602,Census Tract 9506.02,2664,2616,48,4,2660,2612,2597,1,2,12,0.15,1.8,97.48,0.04,0.08,0.45
21135930100,Census Tract 9301,4098,3983,101,23,4075,3974,3937,22,0,15,0.56,2.46,96.07,0.54,0.0,0.37
21135930200,Census Tract 9302,3679,3574,103,19,3660,3557,3539,9,3,6,0.52,2.8,96.19,0.24,0.08,0.16
21135930300,Census Tract 9303,3462,3373,81,29,3433,3352,3341,5,3,3,0.84,2.34,96.5,0.14,0.09,0.09
21135930400,Census Tract 9304,1841,1795,40,12,1829,1789,1782,0,3,4,0.65,2.17,96.8,0.0,0.16,0.22
21137920101,Census Tract 9201.01,2016,1956,52,54,1962,1910,1772,134,4,0,2.68,2.58,87.9,6.65,0.2,0.0
21137920102,Census Tract 9201.02,4756,4587,139,124,4632,4493,4272,175,29,17,2.61,2.92,89.82,3.68,0.61,0.36
21137920103,Census Tract 9201.03,2423,2312,92,62,2361,2269,2172,82,3,12,2.56,3.8,89.64,3.38,0.12,0.5
21137920200,Census Tract 9202,5554,5357,169,96,5458,5289,5226,37,14,12,1.73,3.04,94.09,0.67,0.25,0.22
21137920301,Census Tract 9203.01,3065,2971,81,39,3026,2945,2935,9,0,1,1.27,2.64,95.76,0.29,0.0,0.03
21137920302,Census Tract 9203.02,2370,2256,95,40,2330,2235,2212,9,4,10,1.69,4.01,93.33,0.38,0.17,0.42
21137920400,Census Tract 9204,4091,3987,79,60,4031,3952,3904,13,6,29,1.47,1.93,95.43,0.32,0.15,0.71
21139040100,Census Tract 401,2665,2541,111,43,2622,2511,2489,7,3,12,1.61,4.17,93.4,0.26,0.11,0.45
21139040201,Census Tract 402.01,3351,3153,176,83,3268,3092,3062,11,6,13,2.48,5.25,91.38,0.33,0.18,0.39
21139040202,Census Tract 402.02,2872,2745,107,60,2812,2705,2681,7,3,14,2.09,3.73,93.35,0.24,0.1,0.49
21141960100,Census Tract 9601,5888,5640,202,105,5783,5581,5419,122,12,28,1.78,3.43,92.03,2.07,0.2,0.48
21141960200,Census Tract 9602,3621,3471,112,74,3547,3435,3401,19,6,9,2.04,3.09,93.92,0.52,0.17,0.25
21141960300,Census Tract 9603,5797,5550,217,223,5574,5357,4677,624,22,34,3.85,3.74,80.68,10.76,0.38,0.59
21141960400,Census Tract 9604,5003,4761,189,204,4799,4610,4200,351,31,28,4.08,3.78,83.95,7.02,0.62,0.56
21141960500,Census Tract 9605,4308,4114,160,94,4214,4054,3641,369,20,24,2.18,3.71,84.52,8.57,0.46,0.56
21141960600,Census Tract 9606,2815,2690,106,153,2662,2556,2343,195,4,14,5.44,3.77,83.23,6.93,0.14,0.5
21143960101,Census Tract 9601.01,3517,3429,82,48,3469,3387,3058,293,12,24,1.36,2.33,86.95,8.33,0.34,0.68
21143960102,Census Tract 9601.02,3365,3250,83,90,3275,3192,2947,213,19,13,2.67,2.47,87.58,6.33,0.56,0.39
21143960200,Census Tract 9602,1798,1749,43,14,1784,1741,1728,1,3,9,0.78,2.39,96.11,0.06,0.17,0.5
21143980100,Census Tract 9801,0,0,0,0,0,0,0,0,0,0,,,,,,
21145030100,Census Tract 301,1129,1014,68,154,975,907,733,158,10,6,13.64,6.02,64.92,13.99,0.89,0.53
21145030200,Census Tract 302,1732,1574,114,107,1625,1511,741,751,4,15,6.18,6.58,42.78,43.36,0.23,0.87
21145030300,Census Tract 303,1556,1467,71,42,1514,1443,1160,270,5,8,2.7,4.56,74.55,17.35,0.32,0.51
21145030400,Census Tract 304,1596,1480,104,29,1567,1463,496,957,4,6,1.82,6.52,31.08,59.96,0.25,0.38
21145030500,Census Tract 305,2346,2197,122,152,2194,2072,1352,646,20,54,6.48,5.2,57.63,27.54,0.85,2.3
21145030600,Census Tract 306,3571,3256,254,158,3413,3159,2253,844,20,42,4.42,7.11,63.09,23.63,0.56,1.18
21145030700,Census Tract 307,4398,4068,289,142,4256,3967,2692,1186,48,41,3.23,6.57,61.21,26.97,1.09,0.93
21145030800,Census Tract 308,4937,4680,192,131,4806,4614,4298,230,64,22,2.65,3.89,87.06,4.66,1.3,0.45
21145030900,Census Tract 309,3398,3190,166,188,3210,3044,2330,663,30,21,5.53,4.89,68.57,19.51,0.88,0.62
21145031000,Census Tract 310,4250,3962,257,115,4135,3878,3641,196,11,30,2.71,6.05,85.67,4.61,0.26,0.71
21145031100,Census Tract 311,5891,5547,296,119,5772,5476,5238,168,48,22,2.02,5.02,88.92,2.85,0.81,0.37
21145031200,Census Tract 312,4482,4233,210,109,4373,4163,4044,84,18,17,2.43,4.69,90.23,1.87,0.4,0.38
21145031301,Census Tract 313.01,5307,4941,286,183,5124,4838,4217,506,81,34,3.45,5.39,79.46,9.53,1.53,0.64
21145031302,Census Tract 313.02,6186,5932,206,122,6064,5858,5557,198,87,16,1.97,3.33,89.83,3.2,1.41,0.26
21145031401,Census Tract 314.01,1759,1656,87,47,1712,1625,1478,101,33,13,2.67,4.95,84.03,5.74,1.88,0.74
21145031402,Census Tract 314.02,5963,5678,216,138,5825,5609,5098,369,125,17,2.31,3.62,85.49,6.19,2.1,0.29
21145031501,Census Tract 315.01,2213,2092,92,53,2160,2068,1987,62,8,11,2.39,4.16,89.79,2.8,0.36,0.5
21145031502,Census Tract 315.02,4147,3915,199,78,4069,3870,3728,91,31,20,1.88,4.8,89.9,2.19,0.75,0.48
21145031600,Census Tract 316,3014,2890,100,68,2946,2846,2758,59,13,16,2.26,3.32,91.51,1.96,0.43,0.53
21147960100,Census Tract 9601,2232,2178,35,41,2191,2156,2133,8,5,10,1.84,1.57,95.56,0.36,0.22,0.45
21147960200,Census Tract 9602,918,898,18,4,914,896,896,0,0,0,0.44,1.96,97.6,0.0,0.0,0.0
21147960301,Census Tract 9603.01,3430,3329,88,32,3398,3310,3282,6,4,18,0.93,2.57,95.69,0.17,0.12,0.52
21147960302,Census Tract 9603.02,3115,3000,103,28,3087,2984,2965,0,6,13,0.9,3.31,95.18,0.0,0.19,0.42
21147960401,Census Tract 9604.01,3419,3334,79,221,3198,3119,2234,844,12,29,6.46,2.31,65.34,24.69,0.35,0.85
21147960402,Census Tract 9604.02,3774,3660,110,39,3735,3625,3562,50,5,8,1.03,2.91,94.38,1.32,0.13,0.21
21149970100,Census Tract 9701,2929,2853,58,61,2868,2810,2773,8,9,20,2.08,1.98,94.67,0.27,0.31,0.68
21149970200,Census Tract 9702,3365,3265,79,46,3319,3240,3217,8,4,11,1.37,2.35,95.6,0.24,0.12,0.33
21149970500,Census Tract 9705,2858,2771,60,57,2801,2741,2701,31,0,9,1.99,2.1,94.51,1.08,0.0,0.31
21151010101,Census Tract 101.01,2239,2151,69,74,2165,2096,2068,11,7,10,3.31,3.08,92.36,0.49,0.31,0.45
21151010103,Census Tract 101.03,3676,3483,162,76,3600,3438,3295,76,53,14,2.07,4.41,89.64,2.07,1.44,0.38
21151010104,Census Tract 101.04,4114,3934,153,144,3970,3817,3700,77,17,23,3.5,3.72,89.94,1.87,0.41,0.56
21151010201,Census Tract 102.01,2213,2062,123,58,2155,2032,1839,161,30,2,2.62,5.56,83.1,7.28,1.36,0.09
21151010202,Census Tract 102.02,1677,1563,94,69,1608,1514,1382,121,7,4,4.11,5.61,82.41,7.22,0.42,0.24
21151010301,Census Tract 103.01,5325,4928,325,181,5144,4819,4180,492,105,42,3.4,6.1,78.5,9.24,1.97,0.79
21151010302,Census Tract 103.02,2670,2475,142,136,2534,2392,2109,188,69,26,5.09,5.32,78.99,7.04,2.58,0.97
21151010303,Census Tract 103.03,1929,1772,115,90,1839,1724,1475,206,24,19,4.67,5.96,76.46,10.68,1.24,0.98
21151010400,Census Tract 104,2098,1945,133,56,2042,1909,1611,278,7,13,2.67,6.34,76.79,13.25,0.33,0.62
21151010500,Census Tract 105,2606,1981,611,114,2492,1881,1680,167,9,25,4.37,23.45,64.47,6.41,0.35,0.96
21151010601,Census Tract 106.01,3207,3086,79,93,3114,3035,2829,138,50,18,2.9,2.46,88.21,4.3,1.56,0.56
21151010602,Census Tract 106.02,2293,2152,120,70,2223,2103,1994,77,11,21,3.05,5.23,86.96,3.36,0.48,0.92
21151010701,Census Tract 107.01,4890,4474,349,196,4694,4345,3993,294,29,29,4.01,7.14,81.66,6.01,0.59,0.59
21151010702,Census Tract 107.02,4201,3970,172,147,4054,3882,3604,145,113,20,3.5,4.09,85.79,3.45,2.69,0.48
21151010801,Census Tract 108.01,2428,2318,86,50,2378,2292,2256,17,5,14,2.06,3.54,92.92,0.7,0.21,0.58
21151010802,Census Tract 108.02,2201,2107,80,38,2163,2083,2000,42,36,5,1.73,3.63,90.87,1.91,1.64,0.23
21151010901,Census Tract 109.01,4191,4001,159,83,4108,3949,3829,86,19,15,1.98,3.79,91.36,2.05,0.45,0.36
21151010902,Census Tract 109.02,4002,3787,164,232,3770,3606,3306,174,104,22,5.8,4.1,82.61,4.35,2.6,0.55
21151010903,Census Tract 109.03,3905,3635,210,245,3660,3450,3063,318,47,22,6.27,5.38,78.44,8.14,1.2,0.56
21151011001,Census Tract 110.01,3654,3497,138,62,3592,3454,3367,46,28,13,1.7,3.78,92.15,1.26,0.77,0.36
21151011002,Census Tract 110.02,3170,3066,79,48,3122,3043,2993,31,8,11,1.51,2.49,94.42,0.98,0.25,0.35
21151011101,Census Tract 111.01,3052,2948,90,54,2998,2908,2847,40,14,7,1.77,2.95,93.28,1.31,0.46,0.23
21151011102,Census Tract 111.02,1915,1837,74,16,1899,1825,1799,5,8,13,0.84,3.86,93.94,0.26,0.42,0.68
21151011103,Census Tract 111.03,2174,2096,65,41,2133,2068,2050,14,1,3,1.89,2.99,94.3,0.64,0.05,0.14
21151011201,Census Tract 112.01,2483,2346,113,75,2408,2295,2166,81,21,27,3.02,4.55,87.23,3.26,0.85,1.09
21151011202,Census Tract 112.02,4039,3855,155,81,3958,3803,3599,149,20,35,2.01,3.84,89.11,3.69,0.5,0.87
21151011301,Census Tract 113.01,2391,2257,102,92,2299,2197,2122,54,16,5,3.85,4.27,88.75,2.26,0.67,0.21
21151011303,Census Tract 113.03,3058,2839,181,220,2838,2657,2339,252,58,8,7.19,5.92,76.49,8.24,1.9,0.26
21151011304,Census Tract 113.04,1953,1830,92,112,1841,1749,1638,80,24,7,5.73,4.71,83.87,4.1,1.23,0.36
21151011401,Census Tract 114.01,3045,2880,136,76,2969,2833,2751,28,39,15,2.5,4.47,90.34,0.92,1.28,0.49
21151011402,Census Tract 114.02,1902,1800,83,35,1867,1784,1707,32,27,18,1.84,4.36,89.75,1.68,1.42,0.95
21153970100,Census Tract 9701,1343,1317,25,10,1333,1308,1300,3,0,5,0.74,1.86,96.8,0.22,0.0,0.37
21153970201,Census Tract 9702.01,3033,2998,35,3,3030,2995,2979,0,1,15,0.1,1.15,98.22,0.0,0.03,0.49
21153970202,Census Tract 9702.02,2808,2753,44,26,2782,2738,2731,1,2,4,0.93,1.57,97.26,0.04,0.07,0.14
21153970300,Census Tract 9703,2720,2661,53,19,2701,2648,2631,8,2,7,0.7,1.95,96.73,0.29,0.07,0.26
21153970400,Census Tract 9704,1733,1702,27,8,1725,1698,1694,2,0,2,0.46,1.56,97.75,0.12,0.0,0.12
21155970200,Census Tract 9702,4857,4558,222,272,4585,4363,3618,668,51,26,5.6,4.57,74.49,13.75,1.05,0.54
21155970300,Census Tract 9703,1968,1898,60,53,1915,1855,1769,69,12,5,2.69,3.05,89.89,3.51,0.61,0.25
21155970400,Census Tract 9704,3059,2983,68,38,3021,2953,2932,13,5,3,1.24,2.22,95.85,0.42,0.16,0.1
21155970500,Census Tract 9705,1990,1929,49,25,1965,1916,1893,7,4,12,1.26,2.46,95.13,0.35,0.2,0.6
21155970700,Census Tract 9707,5809,5516,220,270,5539,5319,4777,444,46,52,4.65,3.79,82.23,7.64,0.79,0.9
21155970800,Census Tract 9708,1898,1821,70,23,1875,1805,1790,8,5,2,1.21,3.69,94.31,0.42,0.26,0.11
21157950101,Census Tract 9501.01,2691,2585,92,63,2628,2536,2507,8,7,14,2.34,3.42,93.16,0.3,0.26,0.52
21157950102,Census Tract 9501.02,2442,2346,83,43,2399,2316,2293,5,11,7,1.76,3.4,93.9,0.2,0.45,0.29
21157950200,Census Tract 9502,4792,4524,231,73,4719,4488,4434,6,15,33,1.52,4.82,92.53,0.13,0.31,0.69
21157950300,Census Tract 9503,4109,3918,157,63,4046,3889,3848,5,21,15,1.53,3.82,93.65,0.12,0.51,0.37
21157950400,Census Tract 9504,5562,5340,197,118,5444,5247,5139,47,50,11,2.12,3.54,92.39,0.85,0.9,0.2
21157950501,Census Tract 9505.01,2707,2642,49,30,2677,2628,2608,5,14,1,1.11,1.81,96.34,0.18,0.52,0.04
21157950502,Census Tract 9505.02,2936,2818,102,66,2870,2768,2741,12,4,11,2.25,3.47,93.36,0.41,0.14,0.37
21157950601,Census Tract 9506.01,2873,2791,59,40,2833,2774,2751,4,6,13,1.39,2.05,95.75,0.14,0.21,0.45
21157950602,Census Tract 9506.02,2583,2490,80,27,2556,2476,2458,9,0,9,1.05,3.1,95.16,0.35,0.0,0.35
21157950603,Census Tract 9506.03,964,924,29,16,948,919,918,0,1,0,1.66,3.01,95.23,0.0,0.1,0.0
21159950100,Census Tract 9501,3126,3062,61,11,3115,3054,3048,0,3,3,0.35,1.95,97.5,0.0,0.1,0.1
21159950201,Census Tract 9502.01,3276,3245,31,260,3016,2985,2168,774,9,34,7.94,0.95,66.18,23.63,0.27,1.04
21159950202,Census Tract 9502.02,3973,3919,44,19,3954,3910,3897,6,4,3,0.48,1.11,98.09,0.15,0.1,0.08
21159950300,Census Tract 9503,912,894,18,0,912,894,889,0,1,4,0.0,1.97,97.48,0.0,0.11,0.44
21161960100,Census Tract 9601,3353,3221,113,76,3277,3164,3093,57,4,10,2.27,3.37,92.25,1.7,0.12,0.3
21161960200,Census Tract 9602,3305,3015,265,91,3214,2949,2485,451,2,11,2.75,8.02,75.19,13.65,0.06,0.33
21161960300,Census Tract 9603,4141,3895,197,101,4040,3843,3420,342,47,34,2.44,4.76,82.59,8.26,1.13,0.82
21161960400,Census Tract 9604,4640,4456,164,55,4585,4421,4242,116,47,16,1.19,3.53,91.42,2.5,1.01,0.34
21161960500,Census Tract 9605,1681,1623,52,33,1648,1596,1537,51,7,1,1.96,3.09,91.43,3.03,0.42,0.06
21163970100,Census Tract 9701,1040,970,61,46,994,933,869,49,5,10,4.42,5.87,83.56,4.71,0.48,0.96
21163970200,Census Tract 9702,2141,1820,154,365,1776,1622,1072,424,55,71,17.05,7.19,50.07,19.8,2.57,3.32
21163970301,Census Tract 9703.01,3249,3038,172,85,3164,2992,2864,85,14,29,2.62,5.29,88.15,2.62,0.43,0.89
21163970302,Census Tract 9703.02,6221,5818,338,195,6026,5688,5436,138,46,68,3.13,5.43,87.38,2.22,0.74,1.09
21163970401,Census Tract 9704.01,5543,5278,221,114,5429,5208,5079,71,14,44,2.06,3.99,91.63,1.28,0.25,0.79
21163970403,Census Tract 9704.03,4662,4412,196,141,4521,4325,4150,102,45,28,3.02,4.2,89.02,2.19,0.97,0.6
21163970404,Census Tract 9704.04,3607,3358,191,116,3491,3300,3169,66,34,31,3.22,5.3,87.86,1.83,0.94,0.86
21163970500,Census Tract 9705,3526,3376,127,69,3457,3330,3269,14,2,45,1.96,3.6,92.71,0.4,0.06,1.28
21163980100,Census Tract 9801,14,10,3,2,12,9,4,3,2,0,14.29,21.43,28.57,21.43,14.29,0.0
21165960100,Census Tract 9601,3760,3657,87,38,3722,3635,3607,17,2,9,1.01,2.31,95.93,0.45,0.05,0.24
21165960200,Census Tract 9602,2353,2294,49,19,2334,2285,2266,13,0,6,0.81,2.08,96.3,0.55,0.0,0.25
21167960100,Census Tract 9601,4517,4333,146,86,4431,4285,4221,24,10,30,1.9,3.23,93.45,0.53,0.22,0.66
21167960200,Census Tract 9602,6123,5827,257,236,5887,5630,5260,317,15,38,3.85,4.2,85.91,5.18,0.24,0.62
21167960300,Census Tract 9603,3891,3674,163,155,3736,3573,3324,188,25,36,3.98,4.19,85.43,4.83,0.64,0.93
21167960400,Census Tract 9604,4574,4333,176,155,4419,4243,4033,166,23,21,3.39,3.85,88.17,3.63,0.5,0.46
21167960500,Census Tract 9605,3536,3381,138,71,3465,3327,3262,53,1,11,2.01,3.9,92.25,1.5,0.03,0.31
21169960100,Census Tract 9601,2308,2250,51,37,2271,2220,2157,54,0,9,1.6,2.21,93.46,2.34,0.0,0.39
21169960200,Census Tract 9602,3133,3045,76,63,3070,2994,2951,30,0,13,2.01,2.43,94.19,0.96,0.0,0.41
21169960300,Census Tract 9603,4845,4671,152,130,4715,4563,4512,30,7,14,2.68,3.14,93.13,0.62,0.14,0.29
21171930100,Census Tract 9301,1955,1930,12,47,1908,1896,1890,1,0,5,2.4,0.61,96.68,0.05,0.0,0.26
21171930200,Census Tract 9302,2225,2164,42,146,2079,2037,2010,19,3,5,6.56,1.89,90.34,0.85,0.13,0.22
21171930300,Census Tract 9303,2726,2650,51,94,2632,2581,2433,136,1,11,3.45,1.87,89.25,4.99,0.04,0.4
21171930400,Census Tract 9304,4432,4283,109,186,4246,4137,4056,62,6,13,4.2,2.46,91.52,1.4,0.14,0.29
21173920100,Census Tract 9201,3521,3362,128,83,3438,3310,3231,36,31,12,2.36,3.64,91.76,1.02,0.88,0.34
21173920201,Census Tract 9202.01,3490,3284,133,222,3268,3135,2961,123,34,17,6.36,3.81,84.84,3.52,0.97,0.49
21173920202,Census Tract 9202.02,4107,3889,161,201,3906,3745,3467,248,11,19,4.89,3.92,84.42,6.04,0.27,0.46
21173920301,Census Tract 9203.01,2992,2858,106,95,2897,2791,2699,53,24,15,3.18,3.54,90.21,1.77,0.8,0.5
21173920302,Census Tract 9203.02,5961,5694,228,158,5803,5575,5404,128,30,13,2.65,3.82,90.66,2.15,0.5,0.22
21173920400,Census Tract 9204,5203,5027,146,62,5141,4995,4959,13,13,10,1.19,2.81,95.31,0.25,0.25,0.19
21173920500,Census Tract 9205,2840,2745,73,104,2736,2663,2642,13,2,6,3.66,2.57,93.03,0.46,0.07,0.21
21175950100,Census Tract 9501,2508,2451,52,14,2494,2442,2433,6,0,3,0.56,2.07,97.01,0.24,0.0,0.12
21175950200,Census Tract 9502,2084,2028,55,12,2072,2017,2009,2,1,5,0.58,2.64,96.4,0.1,0.05,0.24
21175950300,Census Tract 9503,2313,2270,40,11,2302,2262,2245,12,1,4,0.48,1.73,97.06,0.52,0.04,0.17
21175950400,Census Tract 9504,4746,4371,91,364,4382,4291,3793,465,15,18,7.67,1.92,79.92,9.8,0.32,0.38
21175950500,Census Tract 9505,2075,2053,18,16,2059,2041,2030,7,0,4,0.77,0.87,97.83,0.34,0.0,0.19
21177960100,Census Tract 9601,1209,1169,32,18,1191,1159,1138,18,2,1,1.49,2.65,94.13,1.49,0.17,0.08
21177960201,Census Tract 9602.01,4000,3836,83,169,3831,3748,3282,436,6,24,4.22,2.08,82.05,10.9,0.15,0.6
21177960202,Census Tract 9602.02,3207,3094,73,83,3124,3051,2883,129,19,20,2.59,2.28,89.9,4.02,0.59,0.62
21177960300,Census Tract 9603,3603,3509,63,57,3546,3483,3458,12,4,9,1.58,1.75,95.98,0.33,0.11,0.25
21177960400,Census Tract 9604,5086,4952,119,77,5009,4890,4655,194,10,31,1.51,2.34,91.53,3.81,0.2,0.61
21177960500,Census Tract 9605,3417,3288,108,55,3362,3254,3021,213,8,12,1.61,3.16,88.41,6.23,0.23,0.35
21177960600,Census Tract 9606,3188,3089,92,25,3163,3071,2938,127,5,1,0.78,2.89,92.16,3.98,0.16,0.03
21177960700,Census Tract 9607,3703,3600,88,54,3649,3561,3485,60,1,15,1.46,2.38,94.11,1.62,0.03,0.41
21177960800,Census Tract 9608,2032,1947,72,22,2010,1938,1921,10,0,7,1.08,3.54,94.54,0.49,0.0,0.34
21177960900,Census Tract 9609,1483,1446,35,9,1474,1439,1423,4,3,9,0.61,2.36,95.95,0.27,0.2,0.61
21179930100,Census Tract 9301,3726,3595,107,95,3631,3524,3423,84,13,4,2.55,2.87,91.87,2.25,0.35,0.11
21179930201,Census Tract 9302.01,6330,6091,188,114,6216,6028,5889,95,29,15,1.8,2.97,93.03,1.5,0.46,0.24
21179930202,Census Tract 9302.02,2218,2122,67,65,2153,2086,2029,35,10,12,2.93,3.02,91.48,1.58,0.45,0.54
21179930301,Census Tract 9303.01,5380,5103,226,125,5255,5029,4821,171,31,6,2.32,4.2,89.61,3.18,0.58,0.11
21179930303,Census Tract 9303.03,3329,3124,188,113,3216,3028,2560,423,10,35,3.39,5.65,76.9,12.71,0.3,1.05
21179930304,Census Tract 9303.04,6825,6301,386,350,6475,6089,5064,894,101,30,5.13,5.66,74.2,13.1,1.48,0.44
21179930305,Census Tract 9303.05,2120,2023,83,61,2059,1976,1799,153,10,14,2.88,3.92,84.86,7.22,0.47,0.66
21179930400,Census Tract 9304,3615,3462,118,94,3521,3403,3136,225,19,23,2.6,3.26,86.75,6.22,0.53,0.64
21179930500,Census Tract 9305,6895,6607,229,129,6766,6537,6385,87,35,30,1.87,3.32,92.6,1.26,0.51,0.44
21179930600,Census Tract 9306,2900,2806,88,25,2875,2787,2760,8,4,15,0.86,3.03,95.17,0.28,0.14,0.52
21179930700,Census Tract 9307,3400,3299,86,43,3357,3271,3247,8,5,11,1.26,2.53,95.5,0.24,0.15,0.32
21181960100,Census Tract 9601,2107,2044,51,36,2071,2020,2007,0,3,10,1.71,2.42,95.25,0.0,0.14,0.47
21181960200,Census Tract 9602,5430,5266,134,118,5312,5178,5117,41,4,16,2.17,2.47,94.24,0.76,0.07,0.29
21183920100,Census Tract 9201,3129,3078,46,29,3100,3054,3027,18,0,9,0.93,1.47,96.74,0.58,0.0,0.29
21183920200,Census Tract 9202,3797,3681,103,66,3731,3628,3593,13,9,13,1.74,2.71,94.63,0.34,0.24,0.34
21183920300,Census Tract 9203,4260,4096,132,180,4080,3948,3862,39,25,22,4.23,3.1,90.66,0.92,0.59,0.52
21183920400,Census Tract 9204,1839,1806,30,27,1812,1782,1775,3,0,4,1.47,1.63,96.52,0.16,0.0,0.22
21183920501,Census Tract 9205.01,3373,3214,91,361,3012,2921,2860,41,9,11,10.7,2.7,84.79,1.22,0.27,0.33
21183920502,Census Tract 9205.02,3938,3778,133,259,3679,3546,3514,25,0,7,6.58,3.38,89.23,0.63,0.0,0.18
21183920600,Census Tract 9206,2018,1958,47,38,1980,1933,1917,6,1,9,1.88,2.33,95.0,0.3,0.05,0.45
21183920700,Census Tract 9207,1418,1374,43,33,1385,1342,1324,10,1,7,2.33,3.03,93.37,0.71,0.07,0.49
21185030100,Census Tract 301,2426,2333,72,71,2355,2283,2238,21,13,11,2.93,2.97,92.25,0.87,0.54,0.45
21185030200,Census Tract 302,4681,4381,141,254,4427,4286,3529,705,13,39,5.43,3.01,75.39,15.06,0.28,0.83
21185030301,Census Tract 303.01,4030,3596,207,655,3375,3168,2958,165,18,27,16.25,5.14,73.4,4.09,0.45,0.67
21185030302,Census Tract 303.02,4986,4583,270,338,4648,4378,4092,226,44,16,6.78,5.42,82.07,4.53,0.88,0.32
21185030401,Census Tract 304.01,7137,6655,367,264,6873,6506,6226,161,81,38,3.7,5.14,87.24,2.26,1.13,0.53
21185030402,Census Tract 304.02,3337,3133,145,114,3223,3078,2976,49,34,19,3.42,4.35,89.18,1.47,1.02,0.57
21185030501,Census Tract 305.01,4493,4160,220,284,4209,3989,3781,141,46,21,6.32,4.9,84.15,3.14,1.02,0.47
21185030502,Census Tract 305.02,5048,4842,152,114,4934,4782,4653,54,48,27,2.26,3.01,92.18,1.07,0.95,0.53
21185030601,Census Tract 306.01,6762,6310,325,245,6517,6192,5749,259,154,30,3.62,4.81,85.02,3.83,2.28,0.44
21185030602,Census Tract 306.02,5509,5198,205,229,5280,5075,4887,102,62,24,4.16,3.72,88.71,1.85,1.13,0.44
21185030701,Census Tract 307.01,2775,2618,94,88,2687,2593,2407,51,112,23,3.17,3.39,86.74,1.84,4.04,0.83
21185030703,Census Tract 307.03,4048,3830,162,167,3881,3719,3594,74,32,19,4.13,4.0,88.78,1.83,0.79,0.47
21185030704,Census Tract 307.04,2962,2821,96,101,2861,2765,2504,82,174,5,3.41,3.24,84.54,2.77,5.87,0.17
21185030801,Census Tract 308.01,4581,4345,153,156,4425,4272,3925,62,267,18,3.41,3.34,85.68,1.35,5.83,0.39
21185030802,Census Tract 308.02,4832,4532,230,155,4677,4447,4317,46,62,22,3.21,4.76,89.34,0.95,1.28,0.46
21187970100,Census Tract 9701,3136,2976,125,126,3010,2885,2837,32,8,8,4.02,3.99,90.47,1.02,0.26,0.26
21187970201,Census Tract 9702.01,2345,2249,86,34,2311,2225,2188,21,4,12,1.45,3.67,93.3,0.9,0.17,0.51
21187970202,Census Tract 9702.02,2868,2752,104,47,2821,2717,2675,26,6,10,1.64,3.63,93.27,0.91,0.21,0.35
21187970300,Census Tract 9703,2929,2836,82,44,2885,2803,2786,4,0,13,1.5,2.8,95.12,0.14,0.0,0.44
21189930100,Census Tract 9301,2328,2271,40,21,2307,2267,2249,11,0,7,0.9,1.72,96.61,0.47,0.0,0.3
21189930200,Census Tract 9302,1723,1667,42,21,1702,1660,1656,0,1,3,1.22,2.44,96.11,0.0,0.06,0.17
21191930101,Census Tract 9301.01,3306,3190,102,24,3282,3180,3164,1,4,11,0.73,3.09,95.7,0.03,0.12,0.33
21191930102,Census Tract 9301.02,3617,3498,96,59,3558,3462,3425,14,8,15,1.63,2.65,94.69,0.39,0.22,0.41
21191930200,Census Tract 9302,2627,2532,87,29,2598,2511,2484,8,2,17,1.1,3.31,94.56,0.3,0.08,0.65
21191930300,Census Tract 9303,5094,4900,173,89,5005,4832,4760,33,16,23,1.75,3.4,93.44,0.65,0.31,0.45
21193970300,Census Tract 9703,2872,2812,57,21,2851,2794,2774,6,4,10,0.73,1.98,96.59,0.21,0.14,0.35
21193970400,Census Tract 9704,4425,4305,91,60,4365,4274,4122,59,86,7,1.36,2.06,93.15,1.33,1.94,0.16
21193970501,Census Tract 9705.01,3170,3091,73,21,3149,3076,3022,31,12,11,0.66,2.3,95.33,0.98,0.38,0.35
21193970502,Census Tract 9705.02,2461,2367,88,18,2443,2355,2206,70,71,8,0.73,3.58,89.64,2.84,2.89,0.33
21193970601,Census Tract 9706.01,2095,2041,52,10,2085,2033,2005,22,1,5,0.48,2.48,95.7,1.05,0.05,0.24
21193970602,Census Tract 9706.02,2595,2426,162,36,2559,2397,2166,165,50,16,1.39,6.24,83.47,6.36,1.93,0.62
21193970700,Census Tract 9707,1884,1832,50,4,1880,1830,1808,11,10,1,0.21,2.65,95.97,0.58,0.53,0.05
21193970800,Census Tract 9708,3174,3072,96,13,3161,3065,3050,3,0,12,0.41,3.02,96.09,0.09,0.0,0.38
21193970900,Census Tract 9709,1584,1542,39,5,1579,1540,1535,0,4,1,0.32,2.46,96.91,0.0,0.25,0.06
21193971000,Census Tract 9710,4213,4122,86,33,4180,4094,4060,7,17,10,0.78,2.04,96.37,0.17,0.4,0.24
21195930100,Census Tract 9301,2816,2752,60,23,2793,2733,2719,6,3,5,0.82,2.13,96.56,0.21,0.11,0.18
21195930201,Census Tract 9302.01,2991,2882,90,53,2938,2848,2749,23,59,17,1.77,3.01,91.91,0.77,1.97,0.57
21195930202,Census Tract 9302.02,3080,2987,67,72,3008,2941,2869,15,51,6,2.34,2.18,93.15,0.49,1.66,0.19
21195930301,Census Tract 9303.01,2138,2059,74,84,2054,1980,1757,135,63,25,3.93,3.46,82.18,6.31,2.95,1.17
21195930302,Census Tract 9303.02,1878,1804,60,75,1803,1743,1603,114,17,9,3.99,3.19,85.36,6.07,0.91,0.48
21195930400,Census Tract 9304,3014,2945,59,53,2961,2902,2824,35,40,3,1.76,1.96,93.7,1.16,1.33,0.1
21195930500,Census Tract 9305,2614,2524,80,38,2576,2496,2435,21,34,6,1.45,3.06,93.15,0.8,1.3,0.23
21195930600,Census Tract 9306,3350,3280,64,16,3334,3270,3248,17,2,3,0.48,1.91,96.96,0.51,0.06,0.09
21195930700,Census Tract 9307,2193,2140,48,16,2177,2129,2122,0,5,2,0.73,2.19,96.76,0.0,0.23,0.09
21195930800,Census Tract 9308,2858,2784,72,9,2849,2777,2771,2,2,2,0.31,2.52,96.96,0.07,0.07,0.07
21195930900,Census Tract 9309,1829,1807,19,9,1820,1801,1788,10,1,2,0.49,1.04,97.76,0.55,0.05,0.11
21195931000,Census Tract 9310,1950,1910,35,15,1935,1900,1892,4,0,4,0.77,1.79,97.03,0.21,0.0,0.21
21195931101,Census Tract 9311.01,1935,1911,15,27,1908,1893,1866,6,19,2,1.4,0.78,96.43,0.31,0.98,0.1
21195931102,Census Tract 9311.02,2358,2310,45,9,2349,2304,2293,5,3,3,0.38,1.91,97.24,0.21,0.13,0.13
21195931200,Census Tract 9312,3726,3626,90,46,3680,3590,3577,0,3,10,1.23,2.42,96.0,0.0,0.08,0.27
21195931300,Census Tract 9313,2478,2410,66,7,2471,2405,2393,0,3,9,0.28,2.66,96.57,0.0,0.12,0.36
21195931400,Census Tract 9314,2664,2605,56,31,2633,2577,2492,22,41,22,1.16,2.1,93.54,0.83,1.54,0.83
21195931500,Census Tract 9315,3743,3609,125,26,3717,3592,3534,43,8,7,0.69,3.34,94.42,1.15,0.21,0.19
21195931600,Census Tract 9316,1478,1439,33,13,1465,1432,1417,4,7,4,0.88,2.23,95.87,0.27,0.47,0.27
21195931700,Census Tract 9317,3858,3802,52,26,3832,3780,3755,8,4,13,0.67,1.35,97.33,0.21,0.1,0.34
21195931800,Census Tract 9318,2905,2848,49,37,2868,2819,2803,8,3,5,1.27,1.69,96.49,0.28,0.1,0.17
21195931900,Census Tract 9319,2813,2757,55,10,2803,2748,2728,7,1,12,0.36,1.96,96.98,0.25,0.04,0.43
21197970101,Census Tract 9701.01,1992,1940,45,25,1967,1922,1916,0,1,5,1.26,2.26,96.18,0.0,0.05,0.25
21197970102,Census Tract 9701.02,4742,4629,88,81,4661,4573,4500,27,18,28,1.71,1.86,94.9,0.57,0.38,0.59
21197970201,Census Tract 9702.01,3121,3035,67,61,3060,2993,2965,17,5,6,1.95,2.15,95.0,0.54,0.16,0.19
21197970202,Census Tract 9702.02,3274,3172,91,30,3244,3153,3126,20,6,1,0.92,2.78,95.48,0.61,0.18,0.03
21199930101,Census Tract 9301.01,3090,2987,78,74,3016,2938,2920,6,8,4,2.39,2.52,94.5,0.19,0.26,0.13
21199930102,Census Tract 9301.02,2925,2807,99,51,2874,2775,2747,5,7,16,1.74,3.38,93.91,0.17,0.24,0.55
21199930200,Census Tract 9302,5512,5289,154,157,5355,5201,5137,34,14,16,2.85,2.79,93.2,0.62,0.25,0.29
21199930301,Census Tract 9303.01,2230,2167,59,25,2205,2146,2119,3,4,20,1.12,2.65,95.02,0.13,0.18,0.9
21199930302,Census Tract 9303.02,2823,2738,78,17,2806,2728,2696,9,12,11,0.6,2.76,95.5,0.32,0.43,0.39
21199930401,Census Tract 9304.01,3474,3321,107,128,3346,3239,3165,33,14,27,3.68,3.08,91.11,0.95,0.4,0.78
21199930403,Census Tract 9304.03,2559,2439,68,126,2433,2365,2307,23,29,6,4.92,2.66,90.15,0.9,1.13,0.23
21199930404,Census Tract 9304.04,3401,3256,97,104,3297,3200,3124,26,32,18,3.06,2.85,91.86,0.76,0.94,0.53
21199930503,Census Tract 9305.03,3785,3607,136,83,3702,3566,3478,31,35,22,2.19,3.59,91.89,0.82,0.92,0.58
21199930504,Census Tract 9305.04,3169,3069,76,74,3095,3019,2837,38,117,27,2.34,2.4,89.52,1.2,3.69,0.85
21199930505,Census Tract 9305.05,4127,3968,128,94,4033,3905,3805,43,46,11,2.28,3.1,92.2,1.04,1.11,0.27
21199930506,Census Tract 9305.06,2701,2569,91,149,2552,2461,2338,84,29,10,5.52,3.37,86.56,3.11,1.07,0.37
21199930600,Census Tract 9306,4330,4115,160,210,4120,3960,3757,161,16,26,4.85,3.7,86.77,3.72,0.37,0.6
21199930700,Census Tract 9307,4830,4578,189,186,4644,4455,4297,98,36,24,3.85,3.91,88.96,2.03,0.75,0.5
21199930801,Census Tract 9308.01,3549,3351,152,205,3344,3192,3114,46,11,21,5.78,4.28,87.74,1.3,0.31,0.59
21199930802,Census Tract 9308.02,2533,2444,66,58,2475,2409,2376,17,1,15,2.29,2.61,93.8,0.67,0.04,0.59
21199930900,Census Tract 9309,2640,2530,101,39,2601,2500,2482,4,11,3,1.48,3.83,94.02,0.15,0.42,0.11
21199931000,Census Tract 9310,1620,1555,55,16,1604,1549,1531,3,3,12,0.99,3.4,94.51,0.19,0.19,0.74
21199931101,Census Tract 9311.01,2775,2637,124,50,2725,2601,2569,9,7,16,1.8,4.47,92.58,0.32,0.25,0.58
21199931103,Census Tract 9311.03,1255,1204,51,8,1247,1196,1188,3,0,5,0.64,4.06,94.66,0.24,0.0,0.4
21199931104,Census Tract 9311.04,1706,1644,55,23,1683,1628,1613,1,4,10,1.35,3.22,94.55,0.06,0.23,0.59
21201970100,Census Tract 9701,2193,2131,52,19,2174,2122,2106,6,7,3,0.87,2.37,96.03,0.27,0.32,0.14
21203950100,Census Tract 9501,3081,3001,72,39,3042,2970,2944,9,7,10,1.27,2.34,95.55,0.29,0.23,0.32
21203950201,Census Tract 9502.01,2997,2886,104,33,2964,2860,2839,11,2,8,1.1,3.47,94.73,0.37,0.07,0.27
21203950202,Census Tract 9502.02,3787,3664,115,43,3744,3629,3572,22,15,20,1.14,3.04,94.32,0.58,0.4,0.53
21203950300,Census Tract 9503,3880,3794,74,39,3841,3767,3745,10,1,11,1.01,1.91,96.52,0.26,0.03,0.28
21203950400,Census Tract 9504,2292,2241,47,18,2274,2227,2216,0,3,8,0.79,2.05,96.68,0.0,0.13,0.35
21205950100,Census Tract 9501,5965,5770,165,103,5862,5697,5599,35,41,22,1.73,2.77,93.86,0.59,0.69,0.37
21205950201,Census Tract 9502.01,3601,3481,91,88,3513,3422,3373,24,16,9,2.44,2.53,93.67,0.67,0.44,0.25
21205950202,Census Tract 9502.02,5687,5525,117,188,5499,5382,5036,197,64,85,3.31,2.06,88.55,3.46,1.13,1.49
21205950301,Census Tract 9503.01,2606,2498,100,51,2555,2455,2334,88,26,7,1.96,3.84,89.56,3.38,1.0,0.27
21205950302,Census Tract 9503.02,2897,2796,91,56,2841,2750,2710,23,2,15,1.93,3.14,93.55,0.79,0.07,0.52
21205950400,Census Tract 9504,3906,3789,113,55,3851,3738,3721,5,8,4,1.41,2.89,95.26,0.13,0.2,0.1
21207960101,Census Tract 9601.01,3723,3602,61,234,3489,3428,3370,11,36,11,6.29,1.64,90.52,0.3,0.97,0.3
21207960102,Census Tract 9601.02,5495,5294,125,334,5161,5036,4926,33,41,36,6.08,2.27,89.65,0.6,0.75,0.66
21207960200,Census Tract 9602,1512,1471,28,19,1493,1465,1447,6,0,12,1.26,1.85,95.7,0.4,0.0,0.79
21207960300,Census Tract 9603,3975,3823,129,97,3878,3749,3658,53,18,20,2.44,3.25,92.03,1.33,0.45,0.5
21207960400,Census Tract 9604,3286,3200,69,97,3189,3120,3096,10,9,5,2.95,2.1,94.22,0.3,0.27,0.15
21209040101,Census Tract 401.01,2089,1921,118,179,1910,1792,1418,341,22,11,8.57,5.65,67.88,16.32,1.05,0.53
21209040102,Census Tract 401.02,2469,2300,105,154,2315,2210,1981,200,16,13,6.24,4.25,80.23,8.1,0.65,0.53
21209040203,Census Tract 402.03,4721,4364,223,268,4453,4230,3927,238,48,17,5.68,4.72,83.18,5.04,1.02,0.36
21209040205,Census Tract 402.05,4946,4487,224,791,4155,3931,3561,312,35,23,15.99,4.53,72.0,6.31,0.71,0.47
21209040207,Census Tract 402.07,1260,1186,67,42,1218,1151,1073,66,6,6,3.33,5.32,85.16,5.24,0.48,0.48
21209040208,Census Tract 402.08,2447,2299,126,73,2374,2248,2081,134,17,16,2.98,5.15,85.04,5.48,0.69,0.65
21209040209,Census Tract 402.09,2597,2396,164,160,2437,2273,2030,209,22,12,6.16,6.31,78.17,8.05,0.85,0.46
21209040210,Census Tract 402.10,2010,1831,144,153,1857,1713,1555,147,4,7,7.61,7.16,77.36,7.31,0.2,0.35
21209040301,Census Tract 403.01,3458,3251,159,245,3213,3054,2710,284,53,7,7.09,4.6,78.37,8.21,1.53,0.2
21209040302,Census Tract 403.02,2431,2328,79,59,2372,2293,2186,69,31,7,2.43,3.25,89.92,2.84,1.28,0.29
21209040303,Census Tract 403.03,3555,3339,151,153,3402,3251,2978,139,112,22,4.3,4.25,83.77,3.91,3.15,0.62
21209040400,Census Tract 404,3169,3000,134,98,3071,2937,2868,43,15,11,3.09,4.23,90.5,1.36,0.47,0.35
21209040501,Census Tract 405.01,2706,2585,98,57,2649,2551,2499,33,8,11,2.11,3.62,92.35,1.22,0.3,0.41
21209040502,Census Tract 405.02,4257,4035,178,89,4168,3990,3874,72,25,19,2.09,4.18,91.0,1.69,0.59,0.45
21209040601,Census Tract 406.01,3527,3358,109,102,3425,3316,3144,122,30,20,2.89,3.09,89.14,3.46,0.85,0.57
21209040604,Census Tract 406.04,2798,2677,91,68,2730,2639,2481,111,34,13,2.43,3.25,88.67,3.97,1.22,0.46
21209040605,Census Tract 406.05,2604,2455,96,75,2529,2433,2378,31,7,17,2.88,3.69,91.32,1.19,0.27,0.65
21209040606,Census Tract 406.06,2795,2571,177,93,2702,2525,2259,233,18,15,3.33,6.33,80.82,8.34,0.64,0.54
21209040607,Census Tract 406.07,3316,3113,151,244,3072,2921,2701,123,84,13,7.36,4.55,81.45,3.71,2.53,0.39
21211040101,Census Tract 401.01,3715,3552,133,73,3642,3509,3444,42,10,13,1.97,3.58,92.71,1.13,0.27,0.35
21211040102,Census Tract 401.02,4512,4298,155,160,4352,4197,4102,71,5,19,3.55,3.44,90.91,1.57,0.11,0.42
21211040201,Census Tract 402.01,3281,3074,124,427,2854,2730,2615,80,16,19,13.01,3.78,79.7,2.44,0.49,0.58
21211040202,Census Tract 402.02,5168,4866,184,461,4707,4523,4238,219,40,26,8.92,3.56,82.0,4.24,0.77,0.5
21211040301,Census Tract 403.01,6024,5248,308,1828,4196,3888,2973,835,33,47,30.35,5.11,49.35,13.86,0.55,0.78
21211040302,Census Tract 403.02,3314,2928,161,806,2508,2347,1880,394,42,31,24.32,4.86,56.73,11.89,1.27,0.94
21211040402,Census Tract 404.02,4342,4094,159,185,4157,3998,3760,165,43,30,4.26,3.66,86.6,3.8,0.99,0.69
21211040403,Census Tract 404.03,4394,4053,222,402,3992,3770,3528,191,24,27,9.15,5.05,80.29,4.35,0.55,0.61
21211040404,Census Tract 404.04,3718,3350,224,441,3277,3053,2641,345,46,21,11.86,6.02,71.03,9.28,1.24,0.56
21211040501,Census Tract 405.01,2496,2344,102,111,2385,2283,2219,36,10,18,4.45,4.09,88.9,1.44,0.4,0.72
21211040503,Census Tract 405.03,3696,3441,159,318,3378,3219,2950,192,47,30,8.6,4.3,79.82,5.19,1.27,0.81
21211040504,Census Tract 405.04,3405,3251,105,83,3322,3217,3013,130,45,29,2.44,3.08,88.49,3.82,1.32,0.85
21213970100,Census Tract 9701,2344,2272,61,44,2300,2239,2144,75,2,18,1.88,2.6,91.47,3.2,0.09,0.77
21213970200,Census Tract 9702,5094,4818,228,174,4920,4692,4257,386,20,29,3.42,4.48,83.57,7.58,0.39,0.57
21213970300,Census Tract 9703,5042,4770,228,184,4858,4630,3982,582,24,42,3.65,4.52,78.98,11.54,0.48,0.83
21213970401,Census Tract 9704.01,4493,4182,251,137,4356,4105,3671,376,41,17,3.05,5.59,81.7,8.37,0.91,0.38
21213970402,Census Tract 9704.02,2621,2457,126,109,2512,2386,2147,203,7,29,4.16,4.81,81.92,7.75,0.27,1.11
21215080101,Census Tract 801.01,4830,4576,205,107,4723,4518,4388,81,29,20,2.22,4.24,90.85,1.68,0.6,0.41
21215080102,Census Tract 801.02,6237,5924,242,179,6058,5816,5654,104,36,22,2.87,3.88,90.65,1.67,0.58,0.35
21215080103,Census Tract 801.03,2129,2021,96,33,2096,2000,1971,16,10,3,1.55,4.51,92.58,0.75,0.47,0.14
21215080200,Census Tract 802,6294,5974,272,131,6163,5891,5751,96,15,29,2.08,4.32,91.37,1.53,0.24,0.46
21217920100,Census Tract 9201,2697,2606,67,67,2630,2563,2535,15,3,10,2.48,2.48,93.99,0.56,0.11,0.37
21217920200,Census Tract 9202,3096,3018,66,55,3041,2975,2923,33,14,5,1.78,2.13,94.41,1.07,0.45,0.16
21217920300,Census Tract 9203,4752,4505,186,165,4587,4401,4050,256,78,17,3.47,3.91,85.23,5.39,1.64,0.36
21217920401,Census Tract 9204.01,4468,4289,165,157,4311,4146,3524,438,119,65,3.51,3.69,78.87,9.8,2.66,1.45
21217920402,Census Tract 9204.02,3900,3682,172,112,3788,3616,3418,165,20,13,2.87,4.41,87.64,4.23,0.51,0.33
21217920501,Census Tract 9205.01,2911,2786,94,57,2854,2760,2675,64,8,13,1.96,3.23,91.89,2.2,0.27,0.45
21217920502,Census Tract 9205.02,4199,3974,187,107,4092,3905,3599,281,2,23,2.55,4.45,85.71,6.69,0.05,0.55
21219950100,Census Tract 9501,2899,2800,80,73,2826,2746,2728,5,4,9,2.52,2.76,94.1,0.17,0.14,0.31
21219950200,Census Tract 9502,5437,5212,186,265,5172,4986,4593,361,3,29,4.87,3.42,84.48,6.64,0.06,0.53
21219950300,Census Tract 9503,2457,2274,142,167,2290,2148,1654,458,13,23,6.8,5.78,67.32,18.64,0.53,0.94
21219950400,Census Tract 9504,1450,1378,40,93,1357,1317,1259,56,2,0,6.41,2.76,86.83,3.86,0.14,0.0
21221970100,Census Tract 9701,2674,2574,77,50,2624,2547,2403,136,2,6,1.87,2.88,89.87,5.09,0.07,0.22
21221970201,Census Tract 9702.01,2914,2767,127,63,2851,2724,2173,528,8,15,2.16,4.36,74.57,18.12,0.27,0.51
21221970202,Census Tract 9702.02,3798,3636,139,73,3725,3586,3340,205,12,29,1.92,3.66,87.94,5.4,0.32,0.76
21221970301,Census Tract 9703.01,2647,2544,64,71,2576,2512,2448,51,1,12,2.68,2.42,92.48,1.93,0.04,0.45
21221970302,Census Tract 9703.02,2023,1919,82,58,1965,1883,1838,30,4,11,2.87,4.05,90.86,1.48,0.2,0.54
21221980100,Census Tract 9801,1,1,0,1,0,0,0,0,0,0,100.0,0.0,0.0,0.0,0.0,0.0
21221980200,Census Tract 9802,4,1,2,1,3,1,0,0,0,1,25.0,50.0,0.0,0.0,0.0,25.0
21223100100,Census Tract 1001,3190,3064,95,65,3125,3030,2998,2,13,17,2.04,2.98,93.98,0.06,0.41,0.53
21223100200,Census Tract 1002,5284,5077,177,127,5157,4980,4916,26,14,24,2.4,3.35,93.04,0.49,0.26,0.45
21225950100,Census Tract 9501,1670,1619,44,23,1647,1603,1535,56,0,12,1.38,2.63,91.92,3.35,0.0,0.72
21225950201,Census Tract 9502.01,4806,4570,225,76,4730,4505,3924,531,28,22,1.58,4.68,81.65,11.05,0.58,0.46
21225950202,Census Tract 9502.02,2720,2622,83,46,2674,2591,2288,288,1,14,1.69,3.05,84.12,10.59,0.04,0.51
21225950300,Census Tract 9503,4472,4265,198,43,4429,4231,4055,154,3,19,0.96,4.43,90.68,3.44,0.07,0.42
21227010100,Census Tract 101,2755,2578,125,157,2598,2473,1993,366,92,22,5.7,4.54,72.34,13.28,3.34,0.8
21227010200,Census Tract 102,3524,3220,190,417,3107,2917,1486,1258,143,30,11.83,5.39,42.17,35.7,4.06,0.85
21227010300,Census Tract 103,4503,4033,190,1070,3433,3243,2171,937,112,23,23.76,4.22,48.21,20.81,2.49,0.51
21227010400,Census Tract 104,4168,3955,159,157,4011,3852,3157,553,112,30,3.77,3.81,75.74,13.27,2.69,0.72
21227010500,Census Tract 105,2271,2149,82,95,2176,2094,1926,128,27,13,4.18,3.61,84.81,5.64,1.19,0.57
21227010600,Census Tract 106,4302,3964,217,292,4010,3793,3160,396,124,113,6.79,5.04,73.45,9.21,2.88,2.63
21227010701,Census Tract 107.01,5422,5116,189,384,5038,4849,3551,370,840,88,7.08,3.49,65.49,6.82,15.49,1.62
21227010702,Census Tract 107.02,6647,6244,265,355,6292,6027,3903,545,1448,131,5.34,3.99,58.72,8.2,21.78,1.97
21227010801,Census Tract 108.01,3984,3751,147,268,3716,3569,3113,265,134,57,6.73,3.69,78.14,6.65,3.36,1.43
21227010802,Census Tract 108.02,8708,8251,298,307,8401,8103,7100,329,634,40,3.53,3.42,81.53,3.78,7.28,0.46
21227010804,Census Tract 108.04,2882,2661,182,86,2796,2614,1945,435,190,44,2.98,6.32,67.49,15.09,6.59,1.53
21227010805,Census Tract 108.05,3998,3754,150,239,3759,3609,2887,383,221,118,5.98,3.75,72.21,9.58,5.53,2.95
21227010900,Census Tract 109,4703,4369,261,246,4457,4196,3546,379,197,74,5.23,5.55,75.4,8.06,4.19,1.57
21227011001,Census Tract 110.01,4305,3909,199,914,3391,3192,1607,834,685,66,21.23,4.62,37.33,19.37,15.91,1.53
21227011002,Census Tract 110.02,7852,7151,423,1063,6789,6366,3944,1281,983,158,13.54,5.39,50.23,16.31,12.52,2.01
21227011100,Census Tract 111,7759,7285,355,418,7341,6986,6037,502,361,86,5.39,4.58,77.81,6.47,4.65,1.11
21227011200,Census Tract 112,5369,4919,281,911,4458,4177,2536,1369,211,61,16.97,5.23,47.23,25.5,3.93,1.14
21227011300,Census Tract 113,4733,4343,263,359,4374,4111,3492,509,61,49,7.59,5.56,73.78,10.75,1.29,1.04
21227011401,Census Tract 114.01,7233,6948,208,245,6988,6780,6270,263,192,55,3.39,2.88,86.69,3.64,2.65,0.76
21227011402,Census Tract 114.02,3501,3289,130,150,3351,3221,2847,159,177,38,4.28,3.71,81.32,4.54,5.06,1.09
21227011500,Census Tract 115,7550,7205,259,192,7358,7099,6869,104,70,56,2.54,3.43,90.98,1.38,0.93,0.74
21227011600,Census Tract 116,5964,5735,193,150,5814,5621,5259,310,30,22,2.52,3.24,88.18,5.2,0.5,0.37
21227011701,Census Tract 117.01,5749,5286,342,513,5236,4894,4005,775,53,61,8.92,5.95,69.66,13.48,0.92,1.06
21227011702,Census Tract 117.02,3705,3504,180,98,3607,3427,3299,88,18,22,2.65,4.86,89.04,2.38,0.49,0.59
21227011801,Census Tract 118.01,3187,3090,88,99,3088,3000,2947,29,15,9,3.11,2.76,92.47,0.91,0.47,0.28
21227011802,Census Tract 118.02,2721,2607,89,67,2654,2565,2514,22,11,18,2.46,3.27,92.39,0.81,0.4,0.66
21227011900,Census Tract 119,7059,6715,279,189,6870,6591,6180,215,154,42,2.68,3.95,87.55,3.05,2.18,0.59
21229930100,Census Tract 9301,2833,2741,75,53,2780,2705,2664,21,2,18,1.87,2.65,94.03,0.74,0.07,0.64
21229930201,Census Tract 9302.01,3442,3205,195,279,3163,2968,2413,503,17,35,8.11,5.67,70.1,14.61,0.49,1.02
21229930202,Census Tract 9302.02,3552,3458,70,94,3458,3388,3263,102,15,8,2.65,1.97,91.86,2.87,0.42,0.23
21229930300,Census Tract 9303,2200,2144,48,44,2156,2108,2057,26,4,21,2.0,2.18,93.5,1.18,0.18,0.95
21231920101,Census Tract 9201.01,1626,1567,49,35,1591,1542,1525,4,9,4,2.15,3.01,93.79,0.25,0.55,0.25
21231920102,Census Tract 9201.02,2787,2699,69,50,2737,2668,2590,58,11,9,1.79,2.48,92.93,2.08,0.39,0.32
21231920201,Census Tract 9202.01,1880,1804,46,120,1760,1714,1684,19,5,6,6.38,2.45,89.57,1.01,0.27,0.32
21231920202,Census Tract 9202.02,3851,3664,119,399,3452,3333,3230,85,15,3,10.36,3.09,83.87,2.21,0.39,0.08
21231920300,Census Tract 9203,3815,3725,72,212,3603,3531,3470,42,12,7,5.56,1.89,90.96,1.1,0.31,0.18
21231920401,Census Tract 9204.01,1578,1550,18,45,1533,1515,1487,16,6,6,2.85,1.14,94.23,1.01,0.38,0.38
21231920402,Census Tract 9204.02,1572,1548,20,21,1551,1531,1522,3,0,6,1.34,1.27,96.82,0.19,0.0,0.38
21231920701,Census Tract 9207.01,1031,1006,22,10,1021,999,992,0,1,6,0.97,2.13,96.22,0.0,0.1,0.58
21231920702,Census Tract 9207.02,1415,1386,28,10,1405,1377,1372,1,1,3,0.71,1.98,96.96,0.07,0.07,0.21
21233960100,Census Tract 9601,4431,4246,110,706,3725,3615,3555,22,10,28,15.93,2.48,80.23,0.5,0.23,0.63
21233960200,Census Tract 9602,2756,2657,93,42,2714,2621,2540,72,0,9,1.52,3.37,92.16,2.61,0.0,0.33
21233960300,Census Tract 9603,2102,2026,72,37,2065,1993,1972,8,6,7,1.76,3.43,93.82,0.38,0.29,0.33
21233960400,Census Tract 9604,3728,3527,185,60,3668,3483,3078,374,8,23,1.61,4.96,82.56,10.03,0.21,0.62
21235920100,Census Tract 9201,3058,2909,129,74,2984,2855,2795,15,26,19,2.42,4.22,91.4,0.49,0.85,0.62
21235920200,Census Tract 9202,2896,2788,93,89,2807,2714,2660,16,29,9,3.07,3.21,91.85,0.55,1.0,0.31
21235920301,Census Tract 9203.01,1866,1795,69,17,1849,1780,1772,3,2,3,0.91,3.7,94.96,0.16,0.11,0.16
21235920302,Census Tract 9203.02,4888,4726,128,63,4825,4697,4640,14,25,18,1.29,2.62,94.93,0.29,0.51,0.37
21235920401,Census Tract 9204.01,1975,1925,37,22,1953,1916,1888,9,6,13,1.11,1.87,95.59,0.46,0.3,0.66
21235920402,Census Tract 9204.02,4149,4015,124,58,4091,3967,3938,9,8,12,1.4,2.99,94.91,0.22,0.19,0.29
21235920501,Census Tract 9205.01,1735,1677,47,22,1713,1666,1657,3,6,0,1.27,2.71,95.5,0.17,0.35,0.0
21235920502,Census Tract 9205.02,4401,4222,160,47,4354,4194,4150,36,5,3,1.07,3.64,94.3,0.82,0.11,0.07
21235920601,Census Tract 9206.01,1103,1060,35,24,1079,1044,1015,7,10,12,2.18,3.17,92.02,0.63,0.91,1.09
21235920602,Census Tract 9206.02,4371,4258,73,187,4184,4111,3596,401,80,34,4.28,1.67,82.27,9.17,1.83,0.78
21235920700,Census Tract 9207,4498,4347,130,68,4430,4300,4274,12,2,12,1.51,2.89,95.02,0.27,0.04,0.27
21235920800,Census Tract 9208,1772,1728,40,16,1756,1716,1691,6,5,14,0.9,2.26,95.43,0.34,0.28,0.79
21237930100,Census Tract 9301,2964,2912,41,20,2944,2903,2871,13,2,17,0.67,1.38,96.86,0.44,0.07,0.57
21237930200,Census Tract 9302,3598,3542,48,41,3557,3509,3485,14,3,7,1.14,1.33,96.86,0.39,0.08,0.19
21239050103,Census Tract 501.03,3635,3282,184,602,3033,2849,2392,421,19,17,16.56,5.06,65.8,11.58,0.52,0.47
21239050104,Census Tract 501.04,3937,3658,187,314,3623,3436,3200,195,21,20,7.98,4.75,81.28,4.95,0.53,0.51
21239050105,Census Tract 501.05,3384,3147,150,231,3153,3003,2804,153,37,9,6.83,4.43,82.86,4.52,1.09,0.27
21239050106,Census Tract 501.06,3921,3754,108,197,3724,3616,3493,94,15,14,5.02,2.75,89.08,2.4,0.38,0.36
21239050107,Census Tract 501.07,4167,3949,135,300,3867,3732,3508,174,39,11,7.2,3.24,84.19,4.18,0.94,0.26
21239050200,Census Tract 502,3759,3557,157,119,3640,3483,3434,22,13,14,3.17,4.18,91.35,0.59,0.35,0.37
21239050300,Census Tract 503,1773,1707,47,121,1652,1605,1551,32,6,16,6.82,2.65,87.48,1.8,0.34,0.9
21239050400,Census Tract 504,2295,2207,47,129,2166,2119,1979,120,7,13,5.62,2.05,86.23,5.23,0.31,0.57
